,Player,Span,Mat,Inns,Dis,Ct,St,Ct Wk,Ct Fi,MD,D/I,Unnamed: 11
0,MV Boucher (ICC/SA),1997-2012,147,281,555,532,23,532,0,6 (6ct 0st),1.975,
1,AC Gilchrist (AUS),1999-2008,96,191,416,379,37,379,0,5 (5ct 0st),2.178,
2,IA Healy (AUS),1988-1999,119,224,395,366,29,366,0,6 (6ct 0st),1.7630000000000001,
3,RW Marsh (AUS),1970-1984,96,182,355,343,12,343,0,6 (6ct 0st),1.95,
4,MS Dhoni (INDIA),2005-2014,90,166,294,256,38,256,0,6 (6ct 0st),1.771,
5,AJ Stewart (ENG),1990-2003,133,231,277,263,14,227,36,6 (6ct 0st),1.199,
6,PJL Dujon (WI),1981-1991,81,154,272,267,5,265,2,5 (5ct 0st),1.766,
7,BJ Haddin (AUS),2008-2015,66,128,270,262,8,262,0,6 (6ct 0st),2.109,
8,APE Knott (ENG),1967-1981,95,174,269,250,19,250,0,5 (4ct 1st),1.545,
9,MJ Prior (ENG),2007-2014,79,146,256,243,13,243,0,6 (6ct 0st),1.7530000000000001,
10,BJ Watling (NZ),2009-2019,67,127,236,228,8,218,10,6 (6ct 0st),1.858,
11,Wasim Bari (PAK),1967-1984,81,146,228,201,27,201,0,7 (7ct 0st),1.561,
12,AB de Villiers (SA),2004-2018,114,217,227,222,5,101,121,6 (6ct 0st),1.046,
13,TG Evans (ENG),1946-1959,91,175,219,173,46,173,0,4 (4ct 0st),1.251,
14,RD Jacobs (WI),1998-2004,65,122,219,207,12,207,0,7 (7ct 0st),1.795,
15,D Ramdin (WI),2005-2016,74,131,217,205,12,205,0,5 (5ct 0st),1.656,
16,R Dravid (ICC/INDIA),1996-2012,164,301,210,210,0,0,210,3 (3ct 0st),0.6970000000000001,
17,BB McCullum (NZ),2004-2016,101,186,209,198,11,168,30,5 (5ct 0st),1.123,
18,Kamran Akmal (PAK),2002-2010,53,99,206,184,22,184,0,5 (5ct 0st),2.08,
19,DPMD Jayawardene (SL),1997-2014,149,270,205,205,0,0,205,4 (4ct 0st),0.759,
20,AC Parore (NZ),1990-2002,78,138,204,197,7,194,3,5 (5ct 0st),1.4780000000000002,
21,KC Sangakkara (SL),2000-2015,134,248,202,182,20,131,51,5 (5ct 0st),0.8140000000000001,
22,JH Kallis (ICC/SA),1995-2013,166,315,200,200,0,0,200,4 (4ct 0st),0.634,
23,SMH Kirmani (INDIA),1976-1986,88,151,198,160,38,160,0,6 (5ct 1st),1.311,
24,JM Bairstow (ENG),2012-2019,70,132,197,184,13,173,11,6 (6ct 0st),1.492,
25,RT Ponting (AUS),1995-2012,168,328,196,196,0,0,196,3 (3ct 0st),0.597,
26,DL Murray (WI),1963-1980,62,119,189,181,8,181,0,5 (5ct 0st),1.588,
27,Q de Kock (SA),2014-2019,44,82,187,176,11,176,0,6 (6ct 0st),2.28,
28,ATW Grout (AUS),1957-1966,51,98,187,163,24,163,0,6 (6ct 0st),1.9080000000000001,
29,ME Waugh (AUS),1991-2002,128,245,181,181,0,0,181,4 (4ct 0st),0.738,
30,IDS Smith (NZ),1980-1992,63,109,176,168,8,168,0,7 (7ct 0st),1.614,
31,AN Cook (ENG),2006-2018,161,300,175,175,0,0,175,3 (3ct 0st),0.583,
32,RW Taylor (ENG),1971-1984,57,106,174,167,7,167,0,7 (7ct 0st),1.641,
33,SP Fleming (NZ),1994-2008,111,199,171,171,0,0,171,5 (5ct 0st),0.8590000000000001,
34,GC Smith (ICC/SA),2002-2014,117,225,169,169,0,0,169,5 (5ct 0st),0.7509999999999999,
35,Sarfaraz Ahmed (PAK),2010-2019,49,94,167,146,21,146,0,5 (5ct 0st),1.776,
36,RC Russell (ENG),1988-1998,54,96,165,153,12,153,0,6 (6ct 0st),1.7180000000000002,
37,BC Lara (ICC/WI),1990-2006,131,241,164,164,0,0,164,4 (4ct 0st),0.68,
38,A Flower (ZIM),1992-2002,63,110,160,151,9,142,9,5 (5ct 0st),1.454,
39,MA Taylor (AUS),1989-1999,104,197,157,157,0,0,157,4 (4ct 0st),0.7959999999999999,
40,AR Border (AUS),1978-1994,156,277,156,156,0,0,156,4 (4ct 0st),0.563,
41,HAPW Jayawardene (SL),2000-2015,58,102,156,124,32,124,0,5 (5ct 0st),1.5290000000000001,
42,DJ Richardson (SA),1992-1998,42,77,152,150,2,150,0,5 (5ct 0st),1.974,
43,Moin Khan (PAK),1990-2004,69,124,148,128,20,127,1,5 (4ct 1st),1.193,
44,LRPL Taylor (NZ),2007-2019,98,184,143,143,0,0,143,3 (3ct 0st),0.777,
45,JHB Waite (SA),1951-1965,50,94,141,124,17,124,0,4 (4ct 0st),1.5,
46,Younis Khan (PAK),2000-2017,118,221,139,139,0,0,139,4 (4ct 0st),0.628,
47,TD Paine (AUS),2010-2019,30,58,137,131,6,131,0,5 (5ct 0st),2.362,
48,VVS Laxman (INDIA),1996-2012,134,248,135,135,0,0,135,4 (4ct 0st),0.544,
49,MJ Clarke (AUS),2004-2015,115,223,134,134,0,0,134,3 (3ct 0st),0.6,
0,GO Jones (ENG),2004-2006,34,66,133,128,5,128,0,6 (6ct 0st),2.015,
1,KS More (INDIA),1986-1993,49,90,130,110,20,110,0,5 (0ct 5st),1.444,
2,WAS Oldfield (AUS),1920-1937,54,101,130,78,52,78,0,5 (1ct 4st),1.287,
3,Rashid Latif (PAK),1992-2003,37,69,130,119,11,119,0,6 (6ct 0st),1.8840000000000001,
4,ML Hayden (AUS),1994-2009,103,205,128,128,0,0,128,4 (4ct 0st),0.624,
5,SK Warne (AUS),1992-2007,145,281,125,125,0,0,125,3 (3ct 0st),0.444,
6,HP Tillakaratne (SL),1989-2004,83,141,124,122,2,33,89,5 (5ct 0st),0.879,
7,GS Chappell (AUS),1970-1984,87,165,122,122,0,0,122,4 (4ct 0st),0.7390000000000001,
8,IVA Richards (WI),1974-1991,121,232,122,122,0,0,122,4 (4ct 0st),0.525,
9,AJ Strauss (ENG),2004-2012,100,189,121,121,0,0,121,3 (3ct 0st),0.64,
10,IT Botham (ENG),1977-1992,102,179,120,120,0,0,120,3 (3ct 0st),0.67,
11,MC Cowdrey (ENG),1954-1975,114,214,120,120,0,0,120,3 (3ct 0st),0.56,
12,RS Kaluwitharana (SL),1992-2004,49,87,119,93,26,93,0,5 (5ct 0st),1.367,
13,Mushfiqur Rahim (BDESH),2005-2019,69,118,118,103,15,98,5,5 (5ct 0st),1.0,
14,SPD Smith (AUS),2010-2019,72,137,117,117,0,0,117,5 (5ct 0st),0.8540000000000001,
15,CL Hooper (WI),1987-2002,102,189,115,115,0,0,115,4 (4ct 0st),0.608,
16,SR Tendulkar (INDIA),1989-2013,200,366,115,115,0,0,115,3 (3ct 0st),0.314,
17,JM Parks (ENG),1954-1968,46,86,114,103,11,101,2,5 (5ct 0st),1.325,
18,SR Waugh (AUS),1985-2004,168,318,112,112,0,0,112,3 (3ct 0st),0.35200000000000004,
19,WR Hammond (ENG),1927-1947,85,154,110,110,0,0,110,3 (3ct 0st),0.7140000000000001,
20,JE Root (ENG),2012-2019,89,168,110,110,0,0,110,4 (4ct 0st),0.654,
21,RB Simpson (AUS),1957-1978,62,117,110,110,0,0,110,4 (4ct 0st),0.94,
22,GS Sobers (WI),1954-1974,93,172,109,109,0,0,109,4 (4ct 0st),0.633,
23,HM Amla (SA),2004-2019,124,234,108,108,0,0,108,3 (3ct 0st),0.461,
24,SM Gavaskar (INDIA),1971-1987,125,216,108,108,0,0,108,3 (3ct 0st),0.5,
25,NR Mongia (INDIA),1994-2001,44,77,107,99,8,99,0,5 (5ct 0st),1.389,
26,M Azharuddin (INDIA),1984-2000,99,177,105,105,0,0,105,5 (5ct 0st),0.593,
27,IM Chappell (AUS),1964-1980,75,144,105,105,0,0,105,4 (4ct 0st),0.7290000000000001,
28,GP Thorpe (ENG),1993-2005,100,179,105,105,0,0,105,4 (4ct 0st),0.586,
29,Saleem Yousuf (PAK),1982-1990,32,58,104,91,13,91,0,5 (5ct 0st),1.7930000000000001,
30,GA Gooch (ENG),1975-1995,118,211,103,103,0,0,103,3 (3ct 0st),0.488,
31,WP Saha (INDIA),2010-2019,37,71,103,92,11,92,0,6 (5ct 1st),1.45,
32,JR Murray (WI),1993-2002,33,61,102,99,3,98,1,5 (5ct 0st),1.672,
33,N Dickwella (SL),2014-2019,35,63,101,81,20,80,1,5 (5ct 0st),1.6030000000000002,
34,IR Bell (ENG),2004-2015,118,223,100,100,0,0,100,3 (3ct 0st),0.44799999999999995,
35,DC Boon (AUS),1984-1996,107,195,99,99,0,0,99,4 (4ct 0st),0.507,
36,GRA Langley (AUS),1951-1956,26,51,98,83,15,83,0,5 (5ct 0st),1.921,
37,LEG Ames (ENG),1929-1939,47,87,97,74,23,72,2,4 (4ct 0st),1.114,
38,PD Collingwood (ENG),2003-2011,68,124,96,96,0,1,95,4 (4ct 0st),0.774,
39,CH Gayle (WI),2000-2014,103,190,96,96,0,0,96,3 (3ct 0st),0.505,
40,CG Greenidge (WI),1974-1991,108,208,96,96,0,0,96,3 (3ct 0st),0.461,
41,KJ Wadsworth (NZ),1969-1976,33,59,96,92,4,92,0,5 (5ct 0st),1.6269999999999998,
42,ME Trescothick (ENG),2000-2006,76,139,95,95,0,0,95,4 (4ct 0st),0.6829999999999999,
43,HH Gibbs (SA),1996-2008,90,173,94,94,0,0,94,4 (4ct 0st),0.5429999999999999,
44,Javed Miandad (PAK),1976-1993,124,218,94,93,1,0,93,3 (3ct 0st),0.431,
45,Imtiaz Ahmed (PAK),1952-1962,41,69,93,77,16,74,3,5 (4ct 1st),1.347,
46,AFA Lilley (ENG),1896-1909,35,67,92,70,22,70,0,4 (4ct 0st),1.3730000000000002,
47,JM Anderson (ENG),2003-2019,150,284,91,91,0,0,91,3 (3ct 0st),0.32,
48,V Sehwag (ICC/INDIA),2001-2013,104,192,91,91,0,0,91,3 (3ct 0st),0.473,
49,FCM Alexander (WI),1957-1961,25,47,90,85,5,85,0,5 (5ct 0st),1.9140000000000001,
0,GA Hick (ENG),1991-2001,65,115,90,90,0,0,90,4 (4ct 0st),0.782,
1,CH Lloyd (WI),1966-1985,110,209,90,90,0,0,90,2 (2ct 0st),0.43,
2,RB Richardson (WI),1983-1995,86,164,90,90,0,0,90,3 (3ct 0st),0.5479999999999999,
3,TM Dilshan (SL),1999-2013,87,159,88,88,0,11,77,4 (4ct 0st),0.5529999999999999,
4,LD Chandimal (SL),2011-2019,55,102,87,77,10,62,15,6 (5ct 1st),0.852,
5,AW Greig (ENG),1972-1977,58,107,87,87,0,0,87,4 (4ct 0st),0.813,
6,Khaled Mashud (BDESH),2000-2007,44,61,87,78,9,78,0,4 (4ct 0st),1.426,
7,MEK Hussey (AUS),2005-2013,79,153,85,85,0,0,85,3 (3ct 0st),0.555,
8,MA Atherton (ENG),1989-2001,115,200,83,83,0,0,83,3 (3ct 0st),0.415,
9,SO Dowrich (WI),2015-2019,31,54,83,78,5,78,0,4 (4ct 0st),1.537,
10,G Kirsten (SA),1993-2004,101,191,83,83,0,0,83,4 (4ct 0st),0.434,
11,IR Redpath (AUS),1964-1976,66,123,83,83,0,0,83,3 (3ct 0st),0.674,
12,FM Engineer (INDIA),1961-1975,46,83,82,66,16,66,0,3 (3ct 0st),0.987,
13,CO Browne (WI),1995-2005,20,36,81,79,2,79,0,5 (5ct 0st),2.25,
14,Inzamam-ul-Haq (ICC/PAK),1992-2007,120,219,81,81,0,0,81,4 (4ct 0st),0.369,
15,TW Graveney (ENG),1951-1969,79,152,80,80,0,2,78,3 (3ct 0st),0.526,
16,V Kohli (INDIA),2011-2019,84,160,80,80,0,0,80,3 (3ct 0st),0.5,
17,AM Rahane (INDIA),2013-2019,63,120,80,80,0,0,80,5 (5ct 0st),0.6659999999999999,
18,MS Wade (AUS),2012-2019,31,60,80,69,11,63,6,5 (4ct 1st),1.3330000000000002,
19,JC Buttler (ENG),2014-2019,38,72,79,79,0,56,23,5 (5ct 0st),1.097,
20,ST Jayasuriya (SL),1991-2007,110,196,78,78,0,0,78,3 (3ct 0st),0.397,
21,DB Vengsarkar (INDIA),1976-1992,116,202,78,78,0,0,78,4 (4ct 0st),0.386,
22,Adnan Akmal (PAK),2010-2014,21,41,77,66,11,66,0,6 (6ct 0st),1.8780000000000001,
23,PR Downton (ENG),1981-1988,30,51,75,70,5,70,0,4 (4ct 0st),1.47,
24,AJ Lamb (ENG),1982-1992,79,146,75,75,0,0,75,4 (4ct 0st),0.513,
25,DI Gower (ENG),1978-1992,117,211,74,74,0,0,74,3 (3ct 0st),0.35,
26,JL Langer (AUS),1993-2007,105,206,73,73,0,0,73,2 (2ct 0st),0.354,
27,H Strudwick (ENG),1910-1926,28,50,73,61,12,61,0,4 (2ct 2st),1.46,
28,M Muralitharan (ICC/SL),1992-2010,133,233,72,72,0,0,72,2 (2ct 0st),0.309,
29,PA Patel (INDIA),2002-2018,25,47,72,62,10,62,0,4 (4ct 0st),1.531,
30,SM Pollock (SA),1995-2008,108,205,72,72,0,0,72,3 (3ct 0st),0.35100000000000003,
31,Asad Shafiq (PAK),2010-2019,73,138,71,71,0,0,71,3 (3ct 0st),0.514,
32,MD Crowe (NZ),1982-1995,77,130,71,71,0,0,71,4 (4ct 0st),0.546,
33,SC Ganguly (INDIA),1996-2008,113,208,71,71,0,0,71,3 (3ct 0st),0.341,
34,KS Williamson (NZ),2010-2019,78,147,71,71,0,0,71,3 (3ct 0st),0.48200000000000004,
35,NJ Astle (NZ),1996-2006,81,147,70,70,0,0,70,2 (2ct 0st),0.47600000000000003,
36,Majid Khan (PAK),1964-1983,63,116,70,70,0,5,65,4 (4ct 0st),0.603,
37,DA Warner (AUS),2011-2019,83,160,68,68,0,1,67,4 (4ct 0st),0.425,
38,DJ Cullinan (SA),1993-2001,70,130,67,67,0,0,67,3 (3ct 0st),0.515,
39,N Hussain (ENG),1990-2004,96,165,67,67,0,0,67,3 (3ct 0st),0.406,
40,S Chanderpaul (WI),1994-2015,164,297,66,66,0,0,66,2 (2ct 0st),0.222,
41,AD Mathews (SL),2009-2019,84,152,66,66,0,0,66,3 (3ct 0st),0.434,
42,R Benaud (AUS),1952-1964,63,122,65,65,0,0,65,3 (3ct 0st),0.532,
43,H Carter (AUS),1907-1921,28,55,65,44,21,44,0,4 (4ct 0st),1.181,
44,DL Haynes (WI),1978-1994,116,221,65,65,0,0,65,2 (2ct 0st),0.294,
45,Mohammad Yousuf (PAK),1998-2010,90,168,65,65,0,0,65,3 (3ct 0st),0.386,
46,Saleem Malik (PAK),1982-1999,103,184,65,65,0,0,65,3 (3ct 0st),0.353,
47,DJG Sammy (WI),2007-2013,38,68,65,65,0,0,65,5 (5ct 0st),0.955,
48,JV Coney (NZ),1974-1987,52,97,64,64,0,0,64,3 (3ct 0st),0.659,
49,RN Harvey (AUS),1948-1963,79,152,64,64,0,0,64,4 (4ct 0st),0.42100000000000004,
0,N Kapil Dev (INDIA),1978-1994,131,230,64,64,0,0,64,2 (2ct 0st),0.278,
1,FS Trueman (ENG),1952-1965,67,128,64,64,0,0,64,3 (3ct 0st),0.5,
2,CL Walcott (WI),1948-1960,44,82,64,53,11,27,26,4 (3ct 1st),0.78,
3,FE Woolley (ENG),1909-1934,64,113,64,64,0,1,63,4 (4ct 0st),0.5660000000000001,
4,KD Karthik (INDIA),2004-2018,26,49,63,57,6,51,6,4 (4ct 0st),1.285,
5,JJ Kelly (AUS),1896-1905,36,67,63,43,20,43,0,4 (4ct 0st),0.94,
6,BKG Mendis (SL),2015-2019,42,76,63,63,0,5,58,4 (4ct 0st),0.828,
7,PM Nevill (AUS),2015-2016,17,31,63,61,2,61,0,4 (4ct 0st),2.032,
8,GR Viswanath (INDIA),1969-1983,91,159,63,63,0,0,63,3 (3ct 0st),0.396,
9,D Elgar (SA),2012-2019,60,111,62,62,0,0,62,2 (2ct 0st),0.5579999999999999,
10,RC Fredericks (WI),1968-1977,59,112,62,62,0,0,62,4 (4ct 0st),0.5529999999999999,
11,DA Murray (WI),1978-1982,19,34,62,57,5,57,0,5 (5ct 0st),1.8230000000000002,
12,KP Pietersen (ENG),2005-2014,104,193,62,62,0,0,62,3 (3ct 0st),0.321,
13,BA Stokes (ENG),2013-2019,60,114,62,62,0,0,62,3 (3ct 0st),0.5429999999999999,
14,T Taibu (ZIM),2001-2012,28,42,62,57,5,55,2,4 (4ct 0st),1.476,
15,Azhar Ali (PAK),2010-2019,77,145,61,61,0,0,61,3 (3ct 0st),0.42,
16,JM Blackham (AUS),1877-1894,35,62,61,37,24,35,2,4 (2ct 2st),0.983,
17,MA Butcher (ENG),1997-2004,71,122,61,61,0,0,61,3 (3ct 0st),0.5,
18,ADR Campbell (ZIM),1992-2002,60,105,60,60,0,0,60,3 (3ct 0st),0.5710000000000001,
19,G Duckworth (ENG),1924-1936,24,43,60,45,15,45,0,4 (4ct 0st),1.395,
20,A Kumble (INDIA),1990-2008,132,242,60,60,0,0,60,2 (2ct 0st),0.247,
21,W Rhodes (ENG),1899-1930,58,110,60,60,0,0,60,4 (4ct 0st),0.545,
22,HB Taber (AUS),1966-1970,16,30,60,56,4,56,0,5 (5ct 0st),2.0,
23,MW Gatting (ENG),1978-1995,79,135,59,59,0,0,59,3 (3ct 0st),0.43700000000000006,
24,WK Lees (NZ),1976-1983,21,42,59,52,7,52,0,5 (5ct 0st),1.4040000000000001,
25,DT Lindsay (SA),1963-1970,19,36,59,57,2,54,3,6 (6ct 0st),1.6380000000000001,
26,GAR Lock (ENG),1952-1968,49,93,59,59,0,0,59,3 (3ct 0st),0.634,
27,MS Atapattu (SL),1990-2007,90,159,58,58,0,0,58,3 (3ct 0st),0.364,
28,KF Barrington (ENG),1955-1968,82,153,58,58,0,0,58,3 (3ct 0st),0.379,
29,D Tallon (AUS),1946-1953,21,42,58,50,8,50,0,4 (4ct 0st),1.38,
30,DL Vettori (ICC/NZ),1997-2014,113,205,58,58,0,0,58,3 (3ct 0st),0.282,
31,L Hutton (ENG),1937-1955,79,147,57,57,0,0,57,3 (3ct 0st),0.387,
32,AL Logie (WI),1983-1991,52,98,57,57,0,0,57,4 (4ct 0st),0.581,
33,F du Plessis (SA),2012-2019,62,115,56,56,0,0,56,3 (3ct 0st),0.486,
34,RS Mahanama (SL),1986-1998,52,81,56,56,0,0,56,4 (4ct 0st),0.691,
35,B Mitchell (SA),1929-1949,42,71,56,56,0,0,56,4 (4ct 0st),0.7879999999999999,
36,JT Murray (ENG),1961-1967,21,38,55,52,3,52,0,6 (6ct 0st),1.4469999999999998,
37,KWR Fletcher (ENG),1968-1982,59,106,54,54,0,0,54,3 (3ct 0st),0.509,
38,BN Jarman (AUS),1959-1969,19,36,54,50,4,50,0,4 (4ct 0st),1.5,
39,ND McKenzie (SA),2000-2009,58,111,54,54,0,0,54,3 (3ct 0st),0.486,
40,CMW Read (ENG),1999-2007,15,26,54,48,6,48,0,6 (6ct 0st),2.076,
41,GP Swann (ENG),2008-2013,60,113,54,54,0,0,54,3 (3ct 0st),0.47700000000000004,
42,BA Young (NZ),1993-1999,35,58,54,54,0,0,54,3 (3ct 0st),0.9309999999999999,
43,RR Pant (INDIA),2018-2019,11,22,53,51,2,51,0,6 (6ct 0st),2.4090000000000003,
44,RR Sarwan (WI),2000-2011,87,162,53,53,0,0,53,2 (2ct 0st),0.327,
45,MJK Smith (ENG),1958-1972,50,91,53,53,0,0,53,3 (3ct 0st),0.5820000000000001,
46,ED Solkar (INDIA),1969-1977,27,50,53,53,0,0,53,4 (4ct 0st),1.06,
47,JM Brearley (ENG),1976-1981,39,75,52,52,0,0,52,3 (3ct 0st),0.693,
48,A Flintoff (ENG/ICC),1998-2009,79,144,52,52,0,0,52,3 (3ct 0st),0.361,
49,LR Gibbs (WI),1958-1976,79,151,52,52,0,0,52,3 (3ct 0st),0.344,
0,WB Phillips (AUS),1983-1986,27,43,52,52,0,43,9,5 (5ct 0st),1.209,
1,TG Southee (NZ),2008-2019,71,135,52,52,0,0,52,2 (2ct 0st),0.385,
2,RP Arnold (SL),1997-2004,44,77,51,51,0,0,51,4 (4ct 0st),0.662,
3,DM Bravo (WI),2010-2019,54,94,51,51,0,0,51,5 (5ct 0st),0.542,
4,HB Cameron (SA),1927-1935,26,45,51,39,12,39,0,4 (2ct 2st),1.133,
5,AE Dick (NZ),1961-1965,17,30,51,47,4,47,0,4 (4ct 0st),1.7,
6,AI Kallicharran (WI),1972-1981,66,124,51,51,0,0,51,2 (2ct 0st),0.41100000000000003,
7,NS Tamhane (INDIA),1955-1961,21,35,51,35,16,35,0,4 (4ct 0st),1.4569999999999999,
8,MJ Guptill (NZ),2009-2016,47,88,50,50,0,0,50,3 (3ct 0st),0.568,
9,KJ Hughes (AUS),1977-1984,70,126,50,50,0,0,50,3 (3ct 0st),0.396,
10,RB Kanhai (WI),1957-1974,79,147,50,50,0,6,44,3 (3ct 0st),0.34,
11,FDM Karunaratne (SL),2012-2019,64,118,50,50,0,0,50,3 (3ct 0st),0.423,
12,Misbah-ul-Haq (PAK),2001-2017,75,143,50,50,0,0,50,3 (3ct 0st),0.349,
13,CA Pujara (INDIA),2010-2019,75,144,50,50,0,0,50,3 (3ct 0st),0.34700000000000003,
14,DCS Compton (ENG),1937-1957,78,146,49,49,0,0,49,2 (2ct 0st),0.335,
15,BM McMillan (SA),1992-1998,38,70,49,49,0,0,49,3 (3ct 0st),0.7,
16,SJ Rhodes (ENG),1994-1995,11,22,49,46,3,46,0,4 (4ct 0st),2.227,
17,M Vijay (INDIA),2008-2018,61,115,49,49,0,0,49,2 (2ct 0st),0.426,
18,ED Weekes (WI),1948-1958,48,90,49,49,0,0,49,4 (4ct 0st),0.544,
19,JC Adams (WI),1992-2001,54,99,48,48,0,0,48,4 (4ct 0st),0.484,
20,CS Baugh (WI),2003-2012,21,38,48,43,5,43,0,5 (4ct 1st),1.263,
21,TL Goddard (SA),1955-1970,41,77,48,48,0,0,48,4 (4ct 0st),0.623,
22,TWM Latham (NZ),2014-2019,49,94,48,48,0,7,41,3 (3ct 0st),0.51,
23,Mudassar Nazar (PAK),1976-1989,76,133,48,48,0,0,48,2 (2ct 0st),0.36,
24,Taufeeq Umar (PAK),2001-2014,44,83,48,48,0,4,44,4 (4ct 0st),0.578,
25,M Amarnath (INDIA),1969-1988,69,115,47,47,0,0,47,3 (3ct 0st),0.408,
26,SL Campbell (WI),1995-2002,52,92,47,47,0,0,47,3 (3ct 0st),0.51,
27,JL Hendriks (WI),1962-1969,20,37,47,42,5,42,0,4 (2ct 2st),1.27,
28,NM Lyon (AUS),2011-2019,95,184,47,47,0,0,47,2 (2ct 0st),0.255,
29,AG Prince (SA),2002-2011,66,124,47,47,0,0,47,3 (3ct 0st),0.379,
30,A Ranatunga (SL),1982-2000,93,148,47,47,0,0,47,3 (3ct 0st),0.317,
31,SJ Rixon (AUS),1977-1985,13,24,47,42,5,42,0,4 (4ct 0st),1.9580000000000002,
32,KR Stackpole (AUS),1966-1974,43,83,47,47,0,0,47,3 (3ct 0st),0.5660000000000001,
33,KL Rahul (INDIA),2014-2019,36,70,46,46,0,1,45,4 (4ct 0st),0.657,
34,AL Wadekar (INDIA),1966-1974,37,69,46,46,0,0,46,4 (4ct 0st),0.6659999999999999,
35,GS Blewett (AUS),1995-2000,46,90,45,45,0,0,45,3 (3ct 0st),0.5,
36,SD Hope (WI),2015-2019,31,56,45,44,1,9,35,5 (5ct 0st),0.8029999999999999,
37,Ijaz Ahmed (PAK),1987-2001,60,110,45,45,0,0,45,3 (3ct 0st),0.409,
38,R Illingworth (ENG),1958-1973,61,115,45,45,0,0,45,3 (3ct 0st),0.391,
39,Mohammad Hafeez (PAK),2003-2018,55,107,45,45,0,0,45,2 (2ct 0st),0.42,
40,TT Samaraweera (SL),2001-2013,81,145,45,45,0,0,45,3 (3ct 0st),0.31,
41,H Trumble (AUS),1890-1904,32,61,45,45,0,0,45,3 (3ct 0st),0.737,
42,SR Watson (AUS),2005-2015,59,113,45,45,0,0,45,3 (3ct 0st),0.39799999999999996,
43,WW Armstrong (AUS),1902-1921,50,96,44,44,0,0,44,2 (2ct 0st),0.45799999999999996,
44,BE Congdon (NZ),1965-1978,61,110,44,44,0,1,43,3 (3ct 0st),0.4,
45,JR Reid (NZ),1949-1965,58,90,44,43,1,4,39,3 (3ct 0st),0.488,
46,DL Underwood (ENG),1966-1982,86,157,44,44,0,0,44,3 (3ct 0st),0.28,
47,MP Vaughan (ENG),1999-2008,82,150,44,44,0,0,44,3 (3ct 0st),0.293,
48,S Venkataraghavan (INDIA),1965-1983,57,101,44,44,0,0,44,4 (4ct 0st),0.435,
49,Wasim Akram (PAK),1985-2002,104,186,44,44,0,0,44,3 (3ct 0st),0.23600000000000002,
0,SCJ Broad (ENG),2007-2019,135,253,43,43,0,0,43,2 (2ct 0st),0.16899999999999998,
1,PA de Silva (SL),1984-2002,93,149,43,43,0,0,43,4 (4ct 0st),0.28800000000000003,
2,JH Edrich (ENG),1963-1976,77,145,43,43,0,0,43,2 (2ct 0st),0.29600000000000004,
3,GW Flower (ZIM),1992-2004,67,114,43,43,0,0,43,3 (3ct 0st),0.377,
4,AW Nourse (SA),1902-1924,45,78,43,43,0,0,43,4 (4ct 0st),0.551,
5,KD Walters (AUS),1965-1981,74,142,43,43,0,0,43,2 (2ct 0st),0.302,
6,FMM Worrell (WI),1948-1963,51,98,43,43,0,0,43,3 (3ct 0st),0.43799999999999994,
7,AK Davidson (AUS),1953-1963,44,85,42,42,0,0,42,4 (4ct 0st),0.494,
8,PH Edmonds (ENG),1975-1987,51,91,42,42,0,0,42,4 (4ct 0st),0.461,
9,J Garner (WI),1977-1987,58,111,42,42,0,0,42,3 (3ct 0st),0.37799999999999995,
10,Harbhajan Singh (INDIA),1998-2015,103,192,42,42,0,0,42,2 (2ct 0st),0.218,
11,Iqbal Qasim (PAK),1976-1988,50,89,42,42,0,0,42,3 (3ct 0st),0.47100000000000003,
12,PBH May (ENG),1951-1961,66,127,42,42,0,0,42,4 (4ct 0st),0.33,
13,Mushtaq Mohammad (PAK),1959-1979,57,102,42,42,0,0,42,2 (2ct 0st),0.41100000000000003,
14,PH Parfitt (ENG),1961-1972,37,73,42,42,0,0,42,4 (4ct 0st),0.575,
15,GM Turner (NZ),1969-1983,41,75,42,42,0,0,42,2 (2ct 0st),0.56,
16,D Williams (WI),1992-1998,11,19,42,40,2,40,0,5 (5ct 0st),2.21,
17,DJ Bravo (WI),2004-2010,40,71,41,41,0,0,41,3 (3ct 0st),0.5770000000000001,
18,JJ Crowe (NZ),1983-1990,39,69,41,41,0,0,41,4 (4ct 0st),0.594,
19,WR Endean (SA),1951-1958,28,52,41,41,0,3,38,3 (3ct 0st),0.7879999999999999,
20,SJ McCabe (AUS),1930-1938,39,73,41,41,0,0,41,3 (3ct 0st),0.561,
21,GM Wood (AUS),1978-1988,59,108,41,41,0,0,41,2 (2ct 0st),0.379,
22,Hanif Mohammad (PAK),1952-1969,55,95,40,40,0,2,38,4 (4ct 0st),0.42100000000000004,
23,Imran Farhat (PAK),2001-2013,40,72,40,40,0,0,40,2 (2ct 0st),0.555,
24,K Srikkanth (INDIA),1981-1992,43,78,40,40,0,0,40,5 (5ct 0st),0.512,
25,LC Braund (ENG),1901-1908,23,44,39,39,0,0,39,4 (4ct 0st),0.8859999999999999,
26,WJ Edrich (ENG),1938-1955,39,70,39,39,0,0,39,3 (3ct 0st),0.557,
27,BN French (ENG),1986-1988,16,25,39,38,1,38,0,4 (4ct 0st),1.56,
28,WG Grace (ENG),1880-1899,22,42,39,39,0,1,38,3 (3ct 0st),0.9279999999999999,
29,Sir RJ Hadlee (NZ),1973-1990,86,156,39,39,0,0,39,2 (2ct 0st),0.25,
30,SM Katich (AUS),2001-2010,56,109,39,39,0,0,39,2 (2ct 0st),0.35700000000000004,
31,MR Ramprakash (ENG),1991-2002,52,93,39,39,0,0,39,3 (3ct 0st),0.419,
32,RA Smith (ENG),1988-1996,62,110,39,39,0,0,39,3 (3ct 0st),0.354,
33,RGD Willis (ENG),1971-1984,90,165,39,39,0,0,39,2 (2ct 0st),0.23600000000000002,
34,CPS Chauhan (INDIA),1969-1981,40,71,38,38,0,0,38,3 (3ct 0st),0.535,
35,JP Duminy (SA),2008-2017,46,83,38,38,0,0,38,3 (3ct 0st),0.457,
36,G Gambhir (INDIA),2004-2016,58,104,38,38,0,0,38,2 (2ct 0st),0.365,
37,GD McGrath (AUS),1993-2007,124,244,38,38,0,0,38,2 (2ct 0st),0.155,
38,Mahmudullah (BDESH),2009-2019,48,84,38,37,1,0,37,3 (3ct 0st),0.452,
39,GR Marsh (AUS),1985-1992,50,89,38,38,0,0,38,2 (2ct 0st),0.426,
40,KR Miller (AUS),1946-1956,55,105,38,38,0,0,38,2 (2ct 0st),0.361,
41,JG Wright (NZ),1978-1993,82,145,38,38,0,0,38,3 (3ct 0st),0.262,
42,CG Borde (INDIA),1958-1969,55,96,37,37,0,0,37,3 (3ct 0st),0.385,
43,JM Gregory (AUS),1920-1928,24,44,37,37,0,0,37,3 (3ct 0st),0.84,
44,Aamer Sohail (PAK),1992-2000,47,87,36,36,0,0,36,3 (3ct 0st),0.413,
45,Asif Iqbal (PAK),1964-1980,58,110,36,36,0,0,36,2 (2ct 0st),0.327,
46,TA Boult (NZ),2011-2019,65,123,36,36,0,0,36,2 (2ct 0st),0.292,
47,RA Harper (WI),1983-1993,25,49,36,36,0,0,36,3 (3ct 0st),0.7340000000000001,
48,AC Hudson (SA),1992-1998,35,63,36,36,0,0,36,4 (4ct 0st),0.5710000000000001,
49,DR Martyn (AUS),1992-2006,67,130,36,36,0,0,36,2 (2ct 0st),0.276,
0,RJ Shastri (INDIA),1981-1992,80,140,36,36,0,0,36,2 (2ct 0st),0.257,
1,PW Sherwell (SA),1906-1911,13,24,36,20,16,20,0,3 (3ct 0st),1.5,
2,DS Smith (WI),2003-2018,43,79,36,36,0,0,36,3 (3ct 0st),0.455,
3,EJ Barlow (SA),1961-1970,30,58,35,35,0,0,35,3 (3ct 0st),0.603,
4,Imrul Kayes (BDESH),2008-2019,39,67,35,35,0,5,30,5 (5ct 0st),0.522,
5,UT Khawaja (AUS),2011-2019,44,83,35,35,0,0,35,3 (3ct 0st),0.42100000000000004,
6,GRJ Roope (ENG),1973-1978,21,37,35,35,0,0,35,3 (3ct 0st),0.945,
7,JK Silva (SL),2011-2018,39,75,35,34,1,6,28,2 (2ct 0st),0.466,
8,FJ Titmus (ENG),1955-1975,53,100,35,35,0,0,35,2 (2ct 0st),0.35,
9,KJ Wright (AUS),1979-1979,10,16,35,31,4,31,0,5 (5ct 0st),2.187,
10,MG Burgess (NZ),1968-1980,50,94,34,34,0,0,34,2 (2ct 0st),0.361,
11,SV Carlisle (ZIM),1995-2005,37,62,34,34,0,0,34,3 (3ct 0st),0.5479999999999999,
12,SS Das (INDIA),2000-2002,23,43,34,34,0,0,34,3 (3ct 0st),0.79,
13,JE Emburey (ENG),1978-1995,64,109,34,34,0,0,34,2 (2ct 0st),0.311,
14,RA Jadeja (INDIA),2012-2019,48,93,34,34,0,0,34,3 (3ct 0st),0.365,
15,DM Jones (AUS),1984-1992,52,91,34,34,0,0,34,2 (2ct 0st),0.373,
16,L Klusener (SA),1996-2004,49,92,34,34,0,0,34,2 (2ct 0st),0.369,
17,GD McKenzie (AUS),1961-1971,60,113,34,34,0,0,34,2 (2ct 0st),0.3,
18,Mohsin Khan (PAK),1978-1986,48,83,34,34,0,0,34,3 (3ct 0st),0.409,
19,Rameez Raja (PAK),1984-1997,57,103,34,34,0,0,34,3 (3ct 0st),0.33,
20,JN Rhodes (SA),1992-2000,52,96,34,34,0,0,34,2 (2ct 0st),0.354,
21,SAR Silva (SL),1983-1988,9,15,34,33,1,33,0,6 (6ct 0st),2.266,
22,Zaheer Abbas (PAK),1969-1985,78,139,34,34,0,0,34,3 (3ct 0st),0.244,
23,G Boycott (ENG),1964-1982,108,193,33,33,0,0,33,2 (2ct 0st),0.17,
24,WJ Cronje (SA),1992-2000,68,128,33,33,0,0,33,2 (2ct 0st),0.257,
25,AF Giles (ENG),1998-2006,54,99,33,33,0,0,33,2 (2ct 0st),0.33299999999999996,
26,AP Gurusinha (SL),1985-1996,41,66,33,33,0,2,31,2 (2ct 0st),0.5,
27,EH Hendren (ENG),1920-1935,51,92,33,33,0,0,33,2 (2ct 0st),0.358,
28,C Hill (AUS),1896-1912,49,93,33,33,0,0,33,3 (3ct 0st),0.354,
29,JO Holder (WI),2014-2019,40,70,33,33,0,0,33,3 (3ct 0st),0.47100000000000003,
30,HJ Howarth (NZ),1969-1977,30,55,33,33,0,0,33,3 (3ct 0st),0.6,
31,MH Mankad (INDIA),1946-1959,44,72,33,33,0,0,33,3 (3ct 0st),0.45799999999999996,
32,MJ Slater (AUS),1993-2001,74,143,33,33,0,0,33,4 (4ct 0st),0.23,
33,PR Umrigar (INDIA),1948-1962,59,101,33,33,0,0,33,3 (3ct 0st),0.326,
34,S Abid Ali (INDIA),1967-1974,29,53,32,32,0,0,32,3 (3ct 0st),0.603,
35,MM Ali (ENG),2014-2019,60,113,32,32,0,0,32,2 (2ct 0st),0.28300000000000003,
36,TE Bailey (ENG),1949-1959,61,118,32,32,0,0,32,2 (2ct 0st),0.271,
37,DG Bradman (AUS),1928-1948,52,99,32,32,0,0,32,2 (2ct 0st),0.32299999999999995,
38,APF Chapman (ENG),1924-1931,26,46,32,32,0,0,32,4 (4ct 0st),0.695,
39,DM de Silva (SL),2016-2019,29,52,32,32,0,0,32,3 (3ct 0st),0.615,
40,WW Hinds (WI),2000-2005,45,83,32,32,0,0,32,3 (3ct 0st),0.385,
41,KR Rutherford (NZ),1985-1995,56,95,32,32,0,0,32,2 (2ct 0st),0.336,
42,TA Ward (SA),1912-1924,23,37,32,19,13,19,0,3 (3ct 0st),0.8640000000000001,
43,TR Ambrose (ENG),2008-2009,11,21,31,31,0,31,0,3 (3ct 0st),1.476,
44,JG Bracewell (NZ),1980-1990,41,73,31,31,0,0,31,3 (3ct 0st),0.424,
45,JT Ikin (ENG),1946-1955,18,32,31,31,0,0,31,3 (3ct 0st),0.968,
46,AN Petersen (SA),2010-2015,36,68,31,31,0,0,31,2 (2ct 0st),0.455,
47,DW Randall (ENG),1977-1984,47,88,31,31,0,0,31,2 (2ct 0st),0.35200000000000004,
48,PK Sen (INDIA),1948-1952,14,21,31,20,11,20,0,4 (4ct 0st),1.476,
49,RG Sharma (INDIA),2013-2019,32,63,31,31,0,0,31,3 (3ct 0st),0.49200000000000005,
0,MS Sinclair (NZ),1999-2010,33,61,31,31,0,1,30,3 (3ct 0st),0.508,
1,VT Trumper (AUS),1899-1912,48,90,31,31,0,0,31,2 (2ct 0st),0.344,
2,WPUJC Vaas (SL),1994-2009,111,196,31,31,0,0,31,2 (2ct 0st),0.158,
3,B Yardley (AUS),1978-1983,33,62,31,31,0,0,31,2 (2ct 0st),0.5,
4,Yuvraj Singh (INDIA),2003-2012,40,76,31,31,0,0,31,2 (2ct 0st),0.40700000000000003,
5,BL Cairns (NZ),1974-1985,43,78,30,30,0,0,30,2 (2ct 0st),0.384,
6,D Ganga (WI),1998-2008,48,87,30,30,0,0,30,3 (3ct 0st),0.344,
7,RG Hart (NZ),2002-2003,11,18,30,29,1,29,0,4 (4ct 0st),1.666,
8,AL Hassett (AUS),1938-1953,43,82,30,30,0,0,30,2 (2ct 0st),0.365,
9,IWG Johnson (AUS),1946-1956,45,86,30,30,0,0,30,3 (3ct 0st),0.348,
10,BK Kunderan (INDIA),1960-1967,18,31,30,23,7,21,2,5 (3ct 2st),0.9670000000000001,
11,WM Lawry (AUS),1961-1971,67,127,30,30,0,0,30,2 (2ct 0st),0.23600000000000002,
12,AA Mallett (AUS),1968-1980,38,73,30,30,0,0,30,2 (2ct 0st),0.41,
13,FLH Mooney (NZ),1949-1954,14,23,30,22,8,22,0,4 (3ct 1st),1.304,
14,JM Parker (NZ),1973-1980,36,65,30,30,0,0,30,3 (3ct 0st),0.461,
15,H Verity (ENG),1931-1939,40,75,30,30,0,0,30,2 (2ct 0st),0.4,
16,KC Wessels (AUS/SA),1982-1994,40,70,30,30,0,0,30,2 (2ct 0st),0.428,
17,PR Adams (SA),1995-2004,45,85,29,29,0,0,29,3 (3ct 0st),0.341,
18,JP Crawley (ENG),1994-2003,37,65,29,29,0,0,29,2 (2ct 0st),0.446,
19,ER Dexter (ENG),1958-1968,62,116,29,29,0,0,29,2 (2ct 0st),0.25,
20,BL D'Oliveira (ENG),1966-1972,44,83,29,29,0,0,29,3 (3ct 0st),0.349,
21,LK Germon (NZ),1995-1997,12,19,29,27,2,27,0,4 (4ct 0st),1.526,
22,GP Howarth (NZ),1975-1985,47,86,29,29,0,0,29,2 (2ct 0st),0.337,
23,Liton Das (BDESH),2015-2019,18,26,29,27,2,20,7,4 (3ct 1st),1.115,
24,AC MacLaren (ENG),1894-1909,35,64,29,29,0,0,29,2 (2ct 0st),0.45299999999999996,
25,H Masakadza (ZIM),2001-2018,38,63,29,29,0,0,29,3 (3ct 0st),0.46,
26,Mominul Haque (BDESH),2013-2019,38,63,29,29,0,0,29,3 (3ct 0st),0.46,
27,KOA Powell (WI),2011-2018,40,72,29,29,0,0,29,3 (3ct 0st),0.402,
28,JA Rudolph (SA),2003-2012,48,92,29,29,0,0,29,2 (2ct 0st),0.315,
29,A Shrewsbury snr (ENG),1881-1893,23,42,29,29,0,0,29,3 (3ct 0st),0.69,
30,IJL Trott (ENG),2009-2015,52,99,29,29,0,0,29,2 (2ct 0st),0.292,
31,CA Walsh (WI),1984-2001,132,244,29,29,0,0,29,2 (2ct 0st),0.11800000000000001,
32,RW Chakabva (ZIM),2011-2018,14,25,28,25,3,24,1,4 (4ct 0st),1.12,
33,LN Constantine (WI),1928-1939,18,29,28,28,0,0,28,3 (3ct 0st),0.965,
34,MH Denness (ENG),1969-1975,28,50,28,28,0,0,28,2 (2ct 0st),0.56,
35,S Dhawan (INDIA),2013-2018,34,66,28,28,0,0,28,2 (2ct 0st),0.424,
36,PSP Handscomb (AUS),2016-2019,16,30,28,28,0,0,28,3 (3ct 0st),0.9329999999999999,
37,Imran Khan (PAK),1971-1992,88,158,28,28,0,0,28,3 (3ct 0st),0.177,
38,GA Lohmann (ENG),1886-1896,18,36,28,28,0,0,28,3 (3ct 0st),0.777,
39,Sadiq Mohammad (PAK),1969-1981,41,74,28,28,0,0,28,2 (2ct 0st),0.37799999999999995,
40,MN Samuels (WI),2000-2016,71,127,28,28,0,0,28,2 (2ct 0st),0.22,
41,MA Starc (AUS),2011-2019,56,109,28,28,0,0,28,2 (2ct 0st),0.256,
42,JB Statham (ENG),1951-1965,70,134,28,28,0,0,28,2 (2ct 0st),0.20800000000000002,
43,TM Alderman (AUS),1981-1991,41,75,27,27,0,0,27,2 (2ct 0st),0.36,
44,J Darling (AUS),1894-1905,34,63,27,27,0,0,27,3 (3ct 0st),0.428,
45,HH Dippenaar (SA),1999-2007,38,72,27,27,0,0,27,2 (2ct 0st),0.375,
46,JN Gillespie (AUS),1996-2006,71,141,27,27,0,0,27,1 (1ct 0st),0.191,
47,MJ Greatbatch (NZ),1988-1996,41,64,27,27,0,0,27,3 (3ct 0st),0.42100000000000004,
48,W Jaffer (INDIA),2000-2008,31,58,27,27,0,0,27,3 (3ct 0st),0.465,
49,MG Johnson (AUS),2007-2015,73,141,27,27,0,0,27,4 (4ct 0st),0.191,
0,PG Joshi (INDIA),1951-1960,12,20,27,18,9,18,0,4 (2ct 2st),1.35,
1,NT Paranavitana (SL),2009-2012,32,53,27,27,0,0,27,2 (2ct 0st),0.509,
2,MAK Pataudi (INDIA),1961-1975,46,84,27,27,0,0,27,2 (2ct 0st),0.321,
3,MDKJ Perera (SL),2015-2019,18,35,27,19,8,14,5,3 (3ct 0st),0.7709999999999999,
4,BRM Taylor (ZIM),2004-2018,28,45,27,27,0,3,24,2 (2ct 0st),0.6,
5,CL Vincent (SA),1927-1935,25,43,27,27,0,0,27,2 (2ct 0st),0.627,
6,SC Williams (WI),1994-2002,31,53,27,27,0,0,27,2 (2ct 0st),0.509,
7,BS Bedi (INDIA),1966-1979,67,121,26,26,0,0,26,1 (1ct 0st),0.214,
8,AV Bedser (ENG),1946-1955,51,93,26,26,0,0,26,2 (2ct 0st),0.27899999999999997,
9,KC Brathwaite (WI),2011-2019,59,104,26,26,0,0,26,2 (2ct 0st),0.25,
10,DR Jardine (ENG),1928-1934,22,42,26,26,0,0,26,3 (3ct 0st),0.619,
11,NV Knight (ENG),1995-2001,17,31,26,26,0,0,26,4 (4ct 0st),0.838,
12,RR Lindwall (AUS),1946-1960,61,117,26,26,0,0,26,2 (2ct 0st),0.222,
13,SV Manjrekar (INDIA),1987-1996,37,68,26,25,1,0,25,3 (3ct 0st),0.382,
14,MA Noble (AUS),1898-1909,42,79,26,26,0,0,26,3 (3ct 0st),0.32899999999999996,
15,MH Richardson (NZ),2000-2004,38,68,26,26,0,0,26,2 (2ct 0st),0.382,
16,Sarfraz Nawaz (PAK),1969-1984,55,98,26,26,0,0,26,3 (3ct 0st),0.265,
17,PV Simmons (WI),1988-1997,26,48,26,26,0,0,26,2 (2ct 0st),0.541,
18,DW Steyn (SA),2004-2019,93,175,26,26,0,0,26,2 (2ct 0st),0.14800000000000002,
19,RF Surti (INDIA),1960-1969,26,47,26,26,0,0,26,3 (3ct 0st),0.5529999999999999,
20,R Swetman (ENG),1959-1960,11,19,26,24,2,24,0,4 (4ct 0st),1.368,
21,HJ Tayfield (SA),1949-1960,37,67,26,26,0,0,26,2 (2ct 0st),0.38799999999999996,
22,Anil Dalpat (PAK),1984-1985,9,15,25,22,3,22,0,3 (3ct 0st),1.666,
23,BS Chandrasekhar (INDIA),1964-1979,58,102,25,25,0,0,25,2 (2ct 0st),0.245,
24,PG Fulton (NZ),2006-2014,23,42,25,25,0,0,25,3 (3ct 0st),0.595,
25,SE Gregory (AUS),1890-1912,58,107,25,25,0,0,25,2 (2ct 0st),0.233,
26,M Hendrick (ENG),1974-1981,30,56,25,25,0,0,25,3 (3ct 0st),0.446,
27,AH Jones (NZ),1987-1995,39,62,25,25,0,0,25,2 (2ct 0st),0.40299999999999997,
28,CC Lewis (ENG),1990-1996,32,58,25,25,0,0,25,2 (2ct 0st),0.431,
29,MD Marshall (WI),1978-1991,81,153,25,25,0,0,25,2 (2ct 0st),0.163,
30,Mohammad Ashraful (BDESH),2001-2013,61,91,25,25,0,0,25,2 (2ct 0st),0.27399999999999997,
31,M Morkel (SA),2006-2018,86,160,25,25,0,0,25,2 (2ct 0st),0.156,
32,M Ntini (SA),1998-2009,101,192,25,25,0,0,25,1 (1ct 0st),0.13,
33,EC Petrie (NZ),1955-1966,14,18,25,25,0,25,0,4 (4ct 0st),1.3880000000000001,
34,DL Amiss (ENG),1966-1977,50,90,24,24,0,0,24,2 (2ct 0st),0.266,
35,R Ashwin (INDIA),2011-2019,70,134,24,24,0,0,24,2 (2ct 0st),0.179,
36,J Blackwood (WI),2014-2019,28,47,24,24,0,0,24,5 (5ct 0st),0.51,
37,DB Close (ENG),1949-1976,22,44,24,24,0,0,24,3 (3ct 0st),0.545,
38,EJM Cowan (AUS),2011-2013,18,35,24,24,0,0,24,3 (3ct 0st),0.685,
39,PB Dassanayake (SL),1993-1994,11,14,24,19,5,19,0,5 (5ct 0st),1.714,
40,GC Dyer (AUS),1986-1988,6,11,24,22,2,22,0,4 (4ct 0st),2.181,
41,G Giffen (AUS),1881-1896,31,55,24,24,0,0,24,3 (3ct 0st),0.436,
42,HMRKB Herath (SL),1999-2018,93,172,24,24,0,0,24,2 (2ct 0st),0.139,
43,MJ Hoggard (ENG),2000-2008,67,125,24,24,0,0,24,2 (2ct 0st),0.192,
44,C Kelleway (AUS),1910-1928,26,47,24,24,0,0,24,3 (3ct 0st),0.51,
45,Mohammad Wasim (PAK),1996-2000,18,32,24,22,2,1,21,2 (2ct 0st),0.75,
46,VY Richardson (AUS),1924-1936,19,37,24,24,0,0,24,5 (5ct 0st),0.648,
47,RA Saggers (AUS),1948-1950,6,11,24,16,8,16,0,4 (1ct 3st),2.181,
48,Shakib Al Hasan (BDESH),2007-2019,56,97,24,24,0,0,24,2 (2ct 0st),0.247,
49,SJ Snooke (SA),1906-1923,26,47,24,24,0,0,24,2 (2ct 0st),0.51,
0,WU Tharanga (SL),2005-2017,31,58,24,24,0,0,24,3 (3ct 0st),0.413,
1,CFK van Wyk (NZ),2012-2012,9,17,24,23,1,23,0,4 (4ct 0st),1.411,
2,PJP Burge (AUS),1955-1966,42,78,23,23,0,0,23,2 (2ct 0st),0.294,
3,RG de Alwis (SL),1983-1988,11,14,23,21,2,21,0,4 (4ct 0st),1.642,
4,GT Dowling (NZ),1961-1972,39,71,23,23,0,0,23,3 (3ct 0st),0.32299999999999995,
5,BF Hastings (NZ),1969-1976,31,54,23,23,0,0,23,3 (3ct 0st),0.425,
6,MG Hughes (AUS),1985-1994,53,97,23,23,0,0,23,2 (2ct 0st),0.237,
7,B Lee (AUS),1999-2008,76,151,23,23,0,0,23,2 (2ct 0st),0.152,
8,DK Lillee (AUS),1971-1984,70,133,23,23,0,0,23,2 (2ct 0st),0.172,
9,RA McLean (SA),1951-1964,40,72,23,23,0,0,23,2 (2ct 0st),0.319,
10,SE Marsh (AUS),2011-2019,38,72,23,23,0,0,23,2 (2ct 0st),0.319,
11,Mushtaq Ahmed (PAK),1990-2003,52,94,23,23,0,0,23,2 (2ct 0st),0.244,
12,SK Raina (INDIA),2010-2015,18,33,23,23,0,0,23,2 (2ct 0st),0.696,
13,SB Styris (NZ),2002-2007,29,51,23,23,0,0,23,3 (3ct 0st),0.45,
14,H Sutcliffe (ENG),1924-1935,54,96,23,23,0,0,23,3 (3ct 0st),0.239,
15,GN Yallop (AUS),1976-1984,39,69,23,23,0,0,23,2 (2ct 0st),0.33299999999999996,
16,KLT Arthurton (WI),1988-1995,33,62,22,22,0,0,22,2 (2ct 0st),0.354,
17,Ashraf Ali (PAK),1982-1987,8,14,22,17,5,17,0,4 (2ct 2st),1.571,
18,GS Ballance (ENG),2014-2017,23,46,22,22,0,0,22,3 (3ct 0st),0.478,
19,IM Barrow (WI),1930-1939,11,16,22,17,5,16,1,3 (3ct 0st),1.375,
20,FR Brown (ENG),1931-1953,22,40,22,22,0,0,22,2 (2ct 0st),0.55,
21,JA Burns (AUS),2014-2019,20,38,22,22,0,0,22,2 (2ct 0st),0.578,
22,Faisal Iqbal (PAK),2001-2010,26,46,22,22,0,0,22,3 (3ct 0st),0.478,
23,JDC Goddard (WI),1948-1957,27,51,22,22,0,0,22,2 (2ct 0st),0.431,
24,Habibul Bashar (BDESH),2000-2008,50,70,22,22,0,0,22,2 (2ct 0st),0.314,
25,MA Holding (WI),1975-1987,60,114,22,22,0,0,22,2 (2ct 0st),0.192,
26,CD McMillan (NZ),1997-2005,55,99,22,22,0,0,22,1 (1ct 0st),0.222,
27,W Mathias (PAK),1955-1962,21,36,22,22,0,0,22,4 (4ct 0st),0.611,
28,RG Nadkarni (INDIA),1955-1968,41,73,22,22,0,0,22,2 (2ct 0st),0.301,
29,CM Old (ENG),1972-1981,46,84,22,22,0,0,22,2 (2ct 0st),0.261,
30,K Rabada (SA),2015-2019,41,76,22,22,0,0,22,2 (2ct 0st),0.289,
31,Shoaib Mohammad (PAK),1983-1995,45,79,22,22,0,0,22,2 (2ct 0st),0.278,
32,J Srinath (INDIA),1991-2002,67,122,22,22,0,0,22,2 (2ct 0st),0.18,
33,A Symonds (AUS),2004-2008,26,52,22,22,0,0,22,3 (3ct 0st),0.423,
34,AC Bannerman (AUS),1879-1893,28,49,21,21,0,0,21,2 (2ct 0st),0.428,
35,RW Barber (ENG),1960-1968,28,49,21,21,0,0,21,2 (2ct 0st),0.428,
36,TE Blain (NZ),1986-1994,11,17,21,19,2,18,1,4 (4ct 0st),1.235,
37,AR Caddick (ENG),1993-2003,62,106,21,21,0,0,21,2 (2ct 0st),0.198,
38,RJ Christiani (WI),1948-1954,22,44,21,19,2,1,18,3 (1ct 2st),0.47700000000000004,
39,RM Cowper (AUS),1964-1968,27,50,21,21,0,0,21,2 (2ct 0st),0.42,
40,TM Findlay (WI),1969-1973,10,17,21,19,2,19,0,4 (4ct 0st),1.235,
41,GB Hole (AUS),1951-1955,18,35,21,21,0,0,21,4 (4ct 0st),0.6,
42,E Jones (AUS),1894-1902,19,34,21,21,0,0,21,3 (3ct 0st),0.617,
43,RB McCosker (AUS),1975-1980,25,47,21,21,0,0,21,2 (2ct 0st),0.446,
44,VL Manjrekar (INDIA),1951-1965,55,96,21,19,2,2,17,2 (2ct 0st),0.218,
45,BAG Murray (NZ),1968-1971,13,25,21,21,0,0,21,2 (2ct 0st),0.84,
46,HM Nicholls (NZ),2016-2019,31,58,21,21,0,0,21,2 (2ct 0st),0.36200000000000004,
47,SM Nurse (WI),1960-1969,29,54,21,21,0,1,20,2 (2ct 0st),0.38799999999999996,
48,NCL O'Neill (AUS),1958-1965,42,82,21,21,0,0,21,2 (2ct 0st),0.256,
49,DG Phadkar (INDIA),1947-1959,31,50,21,21,0,0,21,2 (2ct 0st),0.42,
0,WH Ponsford (AUS),1924-1934,29,55,21,21,0,0,21,2 (2ct 0st),0.381,
1,JA Raval (NZ),2016-2019,23,44,21,21,0,0,21,3 (3ct 0st),0.47700000000000004,
2,CJ Richards (ENG),1986-1988,8,15,21,20,1,20,0,5 (5ct 0st),1.4,
3,I Sharma (INDIA),2007-2019,96,177,21,21,0,0,21,2 (2ct 0st),0.11800000000000001,
4,Soumya Sarkar (BDESH),2015-2019,15,25,21,21,0,0,21,4 (4ct 0st),0.84,
5,CM Spearman (NZ),1995-2000,19,38,21,21,0,0,21,2 (2ct 0st),0.552,
6,GHS Trott (AUS),1888-1898,24,44,21,21,0,0,21,2 (2ct 0st),0.47700000000000004,
7,GOB Allen (ENG),1930-1948,25,47,20,20,0,0,20,2 (2ct 0st),0.425,
8,RG Archer (AUS),1953-1956,19,35,20,20,0,0,20,4 (4ct 0st),0.5710000000000001,
9,D Bishoo (WI),2011-2018,36,64,20,20,0,0,20,3 (3ct 0st),0.312,
10,GA Faulkner (SA),1906-1924,25,44,20,20,0,0,20,3 (3ct 0st),0.45399999999999996,
11,Intikhab Alam (PAK),1959-1977,47,87,20,20,0,0,20,2 (2ct 0st),0.22899999999999998,
12,LV Maddocks (AUS),1954-1956,7,11,20,19,1,19,0,4 (3ct 1st),1.818,
13,RS Morton (WI),2005-2008,15,26,20,20,0,0,20,2 (2ct 0st),0.769,
14,M Prabhakar (INDIA),1984-1995,39,69,20,20,0,0,20,2 (2ct 0st),0.289,
15,GS Ramchand (INDIA),1952-1960,33,57,20,20,0,0,20,3 (3ct 0st),0.35,
16,AC Smith (ENG),1962-1963,6,12,20,20,0,20,0,3 (3ct 0st),1.666,
17,EJ Smith (ENG),1911-1913,11,20,20,17,3,16,1,3 (3ct 0st),1.0,
18,JB Stollmeyer (WI),1939-1955,32,63,20,20,0,0,20,2 (2ct 0st),0.317,
19,B Sutcliffe (NZ),1947-1965,42,61,20,20,0,0,20,2 (2ct 0st),0.327,
20,CJ Tavare (ENG),1980-1989,31,56,20,20,0,0,20,1 (1ct 0st),0.35700000000000004,
21,HDRL Thirimanne (SL),2011-2019,35,65,20,20,0,0,20,2 (2ct 0st),0.307,
22,JR Thomson (AUS),1972-1985,51,94,20,20,0,0,20,1 (1ct 0st),0.212,
23,AEE Vogler (SA),1906-1911,15,28,20,20,0,0,20,4 (4ct 0st),0.7140000000000001,
24,Wasim Raja (PAK),1973-1985,57,98,20,20,0,0,20,2 (2ct 0st),0.204,
25,Yasir Hameed (PAK),2003-2010,25,47,20,20,0,0,20,2 (2ct 0st),0.425,
26,Asif Mujtaba (PAK),1986-1997,25,44,19,19,0,0,19,2 (2ct 0st),0.431,
27,Babar Azam (PAK),2016-2019,25,46,19,19,0,0,19,2 (2ct 0st),0.413,
28,W Barnes (ENG),1880-1890,21,40,19,19,0,0,19,3 (3ct 0st),0.475,
29,MD Bell (NZ),1998-2008,18,33,19,19,0,0,19,2 (2ct 0st),0.575,
30,TW Hayward (ENG),1896-1909,35,67,19,19,0,0,19,2 (2ct 0st),0.28300000000000003,
31,Z Khan (INDIA),2000-2014,92,173,19,19,0,0,19,2 (2ct 0st),0.109,
32,CJ McDermott (AUS),1984-1996,71,126,19,19,0,0,19,2 (2ct 0st),0.15,
33,Mehidy Hasan Miraz (BDESH),2016-2019,22,39,19,19,0,0,19,2 (2ct 0st),0.48700000000000004,
34,R Mutumbami (ZIM),2013-2014,6,12,19,17,2,17,0,5 (4ct 1st),1.5830000000000002,
35,MDK Perera (SL),2014-2019,41,75,19,19,0,0,19,2 (2ct 0st),0.253,
36,V Pollard (NZ),1965-1973,32,57,19,19,0,0,19,3 (3ct 0st),0.33299999999999996,
37,Shahriar Nafees (BDESH),2005-2013,24,38,19,19,0,0,19,2 (2ct 0st),0.5,
38,PM Siddle (AUS),2008-2019,67,128,19,19,0,0,19,2 (2ct 0st),0.14800000000000002,
39,HW Taylor (SA),1912-1932,42,69,19,19,0,0,19,2 (2ct 0st),0.275,
40,G Ulyett (ENG),1877-1890,25,47,19,19,0,0,19,3 (3ct 0st),0.40399999999999997,
41,L Vincent (NZ),2001-2007,23,41,19,19,0,0,19,3 (3ct 0st),0.46299999999999997,
42,GJ Whittall (ZIM),1993-2002,46,81,19,19,0,0,19,3 (3ct 0st),0.23399999999999999,
43,Yasir Shah (PAK),2014-2019,38,72,19,19,0,0,19,2 (2ct 0st),0.263,
44,TJ Zoehrer (AUS),1986-1987,10,16,19,18,1,18,0,3 (3ct 0st),1.187,
45,DW Allan (WI),1962-1966,5,10,18,15,3,15,0,3 (3ct 0st),1.8,
46,CEL Ambrose (WI),1988-2000,98,182,18,18,0,0,18,1 (1ct 0st),0.098,
47,N Boje (SA),2000-2006,43,80,18,18,0,0,18,2 (2ct 0st),0.225,
48,JW Burke (AUS),1951-1959,24,45,18,18,0,0,18,2 (2ct 0st),0.4,
49,NJ Contractor (INDIA),1955-1962,31,54,18,18,0,0,18,2 (2ct 0st),0.33299999999999996,
0,DG Cork (ENG),1995-2002,37,65,18,18,0,0,18,2 (2ct 0st),0.276,
1,Danish Kaneria (PAK),2000-2010,61,115,18,18,0,0,18,1 (1ct 0st),0.156,
2,AA Donald (SA),1992-2002,72,134,18,18,0,0,18,2 (2ct 0st),0.134,
3,JS Foster (ENG),2001-2002,7,13,18,17,1,17,0,5 (5ct 0st),1.3840000000000001,
4,HA Gomes (WI),1976-1987,60,112,18,18,0,0,18,1 (1ct 0st),0.16,
5,GE Gomez (WI),1939-1954,29,58,18,18,0,0,18,3 (3ct 0st),0.31,
6,JR Hazlewood (AUS),2014-2019,51,96,18,18,0,0,18,2 (2ct 0st),0.187,
7,GH Hirst (ENG),1897-1909,24,44,18,18,0,0,18,2 (2ct 0st),0.409,
8,DAJ Holford (WI),1966-1977,24,42,18,18,0,0,18,2 (2ct 0st),0.428,
9,JM How (NZ),2006-2009,19,32,18,18,0,0,18,2 (2ct 0st),0.562,
10,AH Jarvis (AUS),1885-1895,11,19,18,9,9,8,1,3 (3ct 0st),0.9470000000000001,
11,DJ McGlew (SA),1951-1962,34,63,18,18,0,0,18,3 (3ct 0st),0.285,
12,JA Maclean (AUS),1978-1979,4,8,18,18,0,18,0,5 (5ct 0st),2.25,
13,EAS Prasanna (INDIA),1962-1978,49,88,18,18,0,0,18,2 (2ct 0st),0.204,
14,S Ramesh (INDIA),1999-2001,19,36,18,18,0,0,18,2 (2ct 0st),0.5,
15,Saeed Anwar (PAK),1990-2001,55,101,18,18,0,0,18,2 (2ct 0st),0.17800000000000002,
16,RO Schwarz (SA),1906-1912,20,36,18,18,0,0,18,2 (2ct 0st),0.5,
17,Shoaib Malik (PAK),2001-2015,35,67,18,18,0,0,18,2 (2ct 0st),0.268,
18,Waqar Younis (PAK),1989-2003,87,158,18,18,0,0,18,3 (3ct 0st),0.113,
19,GP Wickramasinghe (SL),1991-2001,40,65,18,18,0,0,18,2 (2ct 0st),0.276,
20,SFAF Bacchus (WI),1978-1982,19,34,17,17,0,0,17,3 (3ct 0st),0.5,
21,T Bavuma (SA),2014-2019,39,70,17,17,0,0,17,2 (2ct 0st),0.242,
22,AP Binns (WI),1953-1956,5,10,17,14,3,14,0,3 (3ct 0st),1.7,
23,BC Booth (AUS),1961-1966,29,54,17,17,0,0,17,2 (2ct 0st),0.314,
24,DG Brownlie (NZ),2011-2013,14,25,17,17,0,0,17,4 (4ct 0st),0.68,
25,AN Connolly (AUS),1963-1971,29,55,17,17,0,0,17,2 (2ct 0st),0.309,
26,CB Fry (ENG),1896-1912,26,47,17,17,0,0,17,2 (2ct 0st),0.361,
27,JW Gleeson (AUS),1967-1972,29,56,17,17,0,0,17,2 (2ct 0st),0.303,
28,CV Grimmett (AUS),1925-1936,37,71,17,17,0,0,17,2 (2ct 0st),0.239,
29,JB Hobbs (ENG),1908-1930,61,110,17,17,0,0,17,2 (2ct 0st),0.154,
30,MJ Horne (NZ),1997-2003,35,65,17,17,0,0,17,3 (3ct 0st),0.261,
31,DL Houghton (ZIM),1992-1997,22,40,17,17,0,0,17,3 (3ct 0st),0.425,
32,ML Jaisimha (INDIA),1959-1971,39,72,17,17,0,0,17,1 (1ct 0st),0.23600000000000002,
33,KK Jennings (ENG),2016-2019,17,32,17,17,0,0,17,4 (4ct 0st),0.531,
34,RAS Lakmal (SL),2010-2019,59,109,17,17,0,0,17,1 (1ct 0st),0.155,
35,CG Macartney (AUS),1907-1926,35,64,17,17,0,0,17,1 (1ct 0st),0.265,
36,G MacGregor (ENG),1890-1893,8,15,17,14,3,14,0,3 (3ct 0st),1.133,
37,GRJ Matthews (AUS),1983-1993,33,56,17,17,0,0,17,2 (2ct 0st),0.303,
38,G Miller (ENG),1976-1984,34,62,17,17,0,0,17,2 (2ct 0st),0.27399999999999997,
39,MJ North (AUS),2009-2010,21,40,17,17,0,0,17,2 (2ct 0st),0.425,
40,BP Patel (INDIA),1974-1977,21,37,17,17,0,0,17,3 (3ct 0st),0.45899999999999996,
41,R Peel (ENG),1884-1896,20,38,17,17,0,0,17,2 (2ct 0st),0.447,
42,VD Philander (SA),2011-2019,61,114,17,17,0,0,17,1 (1ct 0st),0.149,
43,RG Pollock (SA),1963-1970,23,44,17,17,0,0,17,2 (2ct 0st),0.386,
44,LG Rowe (WI),1972-1980,30,55,17,17,0,0,17,2 (2ct 0st),0.309,
45,J Ryder (AUS),1920-1929,20,36,17,17,0,0,17,3 (3ct 0st),0.47200000000000003,
46,PJ Sharpe (ENG),1963-1969,12,24,17,17,0,0,17,2 (2ct 0st),0.708,
47,AP Sheahan (AUS),1967-1974,31,60,17,17,0,0,17,1 (1ct 0st),0.28300000000000003,
48,HH Streak (ZIM),1993-2005,65,110,17,17,0,0,17,2 (2ct 0st),0.154,
49,WW Wade (SA),1938-1950,11,18,17,15,2,15,0,3 (3ct 0st),0.9440000000000001,
0,JT Ward (NZ),1964-1968,8,15,17,16,1,16,0,4 (4ct 0st),1.133,
1,AJ Watkins (ENG),1948-1952,15,26,17,17,0,0,17,3 (3ct 0st),0.653,
2,Aamer Malik (PAK),1987-1994,14,26,16,15,1,4,11,4 (4ct 0st),0.615,
3,CT Bancroft (AUS),2017-2019,10,19,16,16,0,0,16,3 (3ct 0st),0.8420000000000001,
4,AJ Bichel (AUS),1997-2003,19,38,16,16,0,0,16,2 (2ct 0st),0.42100000000000004,
5,GJ Bonnor (AUS),1880-1888,17,29,16,16,0,0,16,3 (3ct 0st),0.551,
6,N Deonarine (WI),2005-2013,18,33,16,16,0,0,16,3 (3ct 0st),0.484,
7,M Dillon (WI),1997-2004,38,69,16,16,0,0,16,2 (2ct 0st),0.231,
8,SB Doull (NZ),1992-2000,32,53,16,16,0,0,16,2 (2ct 0st),0.301,
9,DD Ebrahim (ZIM),2001-2005,29,45,16,16,0,0,16,2 (2ct 0st),0.355,
10,ST Gabriel (WI),2012-2019,45,79,16,16,0,0,16,2 (2ct 0st),0.20199999999999999,
11,KD Ghavri (INDIA),1974-1981,39,69,16,16,0,0,16,2 (2ct 0st),0.231,
12,CC Griffith (WI),1960-1969,28,52,16,16,0,0,16,2 (2ct 0st),0.307,
13,SC Guillen (NZ/WI),1951-1956,8,15,16,13,3,13,0,3 (3ct 0st),1.0659999999999998,
14,AJ Hall (SA),2002-2007,21,39,16,16,0,0,16,2 (2ct 0st),0.41,
15,Haroon Rasheed (PAK),1977-1983,23,41,16,16,0,0,16,2 (2ct 0st),0.39,
16,PL Harris (SA),2007-2011,37,69,16,16,0,0,16,2 (2ct 0st),0.231,
17,VA Holder (WI),1969-1979,40,74,16,16,0,0,16,1 (1ct 0st),0.21600000000000003,
18,CC Hunte (WI),1958-1967,44,85,16,16,0,0,16,2 (2ct 0st),0.188,
19,FA Iredale (AUS),1894-1899,14,27,16,16,0,0,16,3 (3ct 0st),0.5920000000000001,
20,KC James (NZ),1930-1933,11,16,16,11,5,11,0,2 (2ct 0st),1.0,
21,WR James (ZIM),1993-1994,4,7,16,16,0,16,0,5 (5ct 0st),2.285,
22,WA Johnston (AUS),1947-1955,40,79,16,16,0,0,16,2 (2ct 0st),0.20199999999999999,
23,AH Kardar (INDIA/PAK),1946-1958,26,45,16,16,0,0,16,2 (2ct 0st),0.355,
24,MS Kasprowicz (AUS),1996-2006,38,75,16,16,0,0,16,2 (2ct 0st),0.213,
25,BM Laird (AUS),1979-1982,21,37,16,16,0,0,16,2 (2ct 0st),0.43200000000000005,
26,SCG MacGill (AUS),1998-2008,44,87,16,16,0,0,16,2 (2ct 0st),0.183,
27,KD Mackay (AUS),1956-1963,37,71,16,16,0,0,16,2 (2ct 0st),0.225,
28,MR Marsh (AUS),2014-2019,32,62,16,16,0,0,16,2 (2ct 0st),0.258,
29,A Nel (SA),2001-2008,36,69,16,16,0,0,16,2 (2ct 0st),0.231,
30,CS Pandit (INDIA),1986-1992,5,9,16,14,2,11,3,4 (4ct 0st),1.777,
31,WW Read (ENG),1882-1893,18,35,16,16,0,0,16,2 (2ct 0st),0.457,
32,P Roy (INDIA),1951-1960,43,72,16,16,0,0,16,2 (2ct 0st),0.222,
33,V Sibanda (ZIM),2003-2014,14,27,16,16,0,0,16,3 (3ct 0st),0.5920000000000001,
34,JA Snow (ENG),1965-1976,49,93,16,16,0,0,16,2 (2ct 0st),0.172,
35,JT Tyldesley (ENG),1899-1909,31,59,16,16,0,0,16,1 (1ct 0st),0.271,
36,RES Wyatt (ENG),1927-1937,40,74,16,16,0,0,16,2 (2ct 0st),0.21600000000000003,
37,UT Yadav (INDIA),2011-2019,45,88,16,16,0,0,16,2 (2ct 0st),0.18100000000000002,
38,Yashpal Sharma (INDIA),1979-1983,37,60,16,16,0,0,16,2 (2ct 0st),0.266,
39,Abdul Qadir (PAK),1977-1990,67,117,15,15,0,0,15,2 (2ct 0st),0.128,
40,Abdul Razzaq (PAK),1999-2006,46,85,15,15,0,0,15,2 (2ct 0st),0.17600000000000002,
41,BF Butcher (WI),1958-1969,44,83,15,15,0,0,15,2 (2ct 0st),0.18,
42,AG Chipperfield (AUS),1934-1938,14,26,15,15,0,0,15,3 (3ct 0st),0.5760000000000001,
43,A Chopra (INDIA),2003-2004,10,19,15,15,0,0,15,3 (3ct 0st),0.789,
44,CI Dunusinghe (SL),1995-1995,5,9,15,13,2,13,0,4 (4ct 0st),1.666,
45,KA Edwards (WI),2011-2014,17,32,15,15,0,0,15,2 (2ct 0st),0.46799999999999997,
46,CR Ervine (ZIM),2011-2017,15,26,15,15,0,0,15,4 (4ct 0st),0.5760000000000001,
47,AG Fairfax (AUS),1929-1931,10,19,15,15,0,0,15,3 (3ct 0st),0.789,
48,AD Gaekwad (INDIA),1974-1985,40,66,15,15,0,0,15,2 (2ct 0st),0.22699999999999998,
49,G Gunn (ENG),1907-1930,15,30,15,15,0,0,15,2 (2ct 0st),0.5,
0,PJ Hughes (AUS),2009-2013,26,48,15,15,0,0,15,2 (2ct 0st),0.312,
1,AO Jones (ENG),1899-1909,12,23,15,15,0,0,15,2 (2ct 0st),0.652,
2,H Larwood (ENG),1926-1933,21,38,15,15,0,0,15,4 (4ct 0st),0.39399999999999996,
3,S Madan Lal (INDIA),1974-1986,39,66,15,15,0,0,15,1 (1ct 0st),0.22699999999999998,
4,PNF Mansell (SA),1951-1955,13,24,15,15,0,0,15,2 (2ct 0st),0.625,
5,AK Markram (SA),2017-2019,20,39,15,15,0,0,15,3 (3ct 0st),0.384,
6,G Millman (ENG),1961-1962,6,12,15,13,2,13,0,4 (2ct 2st),1.25,
7,AR Morris (AUS),1946-1955,46,90,15,15,0,0,15,2 (2ct 0st),0.166,
8,J Mubarak (SL),2002-2015,13,24,15,15,0,0,15,3 (3ct 0st),0.625,
9,WL Murdoch (AUS/ENG),1877-1892,19,36,15,14,1,3,11,3 (3ct 0st),0.41600000000000004,
10,KJ O'Keeffe (AUS),1971-1977,24,47,15,15,0,0,15,2 (2ct 0st),0.319,
11,JDP Oram (NZ),2002-2009,33,60,15,15,0,0,15,2 (2ct 0st),0.25,
12,DN Patel (NZ),1987-1997,37,62,15,15,0,0,15,2 (2ct 0st),0.24100000000000002,
13,PI Pocock (ENG),1968-1985,25,46,15,15,0,0,15,3 (3ct 0st),0.326,
14,MSK Prasad (INDIA),1999-2000,6,11,15,15,0,15,0,4 (4ct 0st),1.3630000000000002,
15,Qasim Umar (PAK),1983-1986,26,42,15,15,0,0,15,2 (2ct 0st),0.35700000000000004,
16,Rajin Saleh (BDESH),2003-2008,24,37,15,15,0,1,14,3 (3ct 0st),0.405,
17,PR Reiffel (AUS),1992-1998,35,68,15,15,0,0,15,1 (1ct 0st),0.22,
18,CJL Rogers (AUS),2008-2015,25,49,15,15,0,0,15,3 (3ct 0st),0.306,
19,Saqlain Mushtaq (PAK),1995-2004,49,87,15,15,0,0,15,2 (2ct 0st),0.172,
20,PA Strang (ZIM),1994-2001,24,44,15,15,0,0,15,3 (3ct 0st),0.34,
21,Taijul Islam (BDESH),2014-2019,27,47,15,15,0,0,15,2 (2ct 0st),0.319,
22,DR Tuffey (NZ),2000-2010,26,46,15,15,0,0,15,2 (2ct 0st),0.326,
23,A Turner (AUS),1975-1977,14,27,15,15,0,0,15,4 (4ct 0st),0.555,
24,W Voce (ENG),1930-1947,27,51,15,15,0,0,15,2 (2ct 0st),0.294,
25,AC Voges (AUS),2015-2016,20,37,15,15,0,0,15,3 (3ct 0st),0.405,
26,CB Wishart (ZIM),1995-2005,27,45,15,15,0,0,15,2 (2ct 0st),0.33299999999999996,
27,Azhar Mahmood (PAK),1997-2001,21,37,14,14,0,0,14,3 (3ct 0st),0.37799999999999995,
28,RG Barlow (ENG),1881-1887,17,31,14,14,0,0,14,2 (2ct 0st),0.451,
29,SG Barnes (AUS),1938-1948,13,25,14,14,0,0,14,3 (3ct 0st),0.56,
30,CJ Barnett (ENG),1933-1948,20,39,14,14,0,0,14,2 (2ct 0st),0.358,
31,SJ Benn (WI),2008-2015,26,45,14,14,0,0,14,2 (2ct 0st),0.311,
32,SL Boock (NZ),1978-1989,30,54,14,14,0,0,14,2 (2ct 0st),0.259,
33,WA Brown (AUS),1934-1948,22,41,14,14,0,0,14,2 (2ct 0st),0.341,
34,CL Cairns (NZ),1989-2004,62,110,14,14,0,0,14,2 (2ct 0st),0.127,
35,RL Chase (WI),2016-2019,32,56,14,14,0,0,14,3 (3ct 0st),0.25,
36,GJ Cosier (AUS),1975-1978,18,34,14,14,0,0,14,2 (2ct 0st),0.41100000000000003,
37,MD Craig (NZ),2014-2016,15,29,14,14,0,0,14,2 (2ct 0st),0.48200000000000004,
38,PAJ DeFreitas (ENG),1986-1995,44,78,14,14,0,0,14,2 (2ct 0st),0.179,
39,C de Grandhomme (NZ),2016-2019,21,41,14,14,0,0,14,2 (2ct 0st),0.341,
40,HDPK Dharmasena (SL),1993-2004,31,53,14,14,0,0,14,3 (3ct 0st),0.264,
41,SS Dighe (INDIA),2001-2001,6,11,14,12,2,12,0,3 (3ct 0st),1.272,
42,RA Duff (AUS),1902-1905,22,41,14,14,0,0,14,2 (2ct 0st),0.341,
43,SA Durani (INDIA),1960-1973,29,53,14,14,0,0,14,3 (3ct 0st),0.264,
44,BA Edgar (NZ),1978-1986,39,72,14,14,0,3,11,3 (3ct 0st),0.19399999999999998,
45,MTG Elliott (AUS),1996-2004,21,42,14,14,0,0,14,1 (1ct 0st),0.33299999999999996,
46,PGH Fender (ENG),1921-1929,13,23,14,14,0,0,14,2 (2ct 0st),0.608,
47,TR Gripper (ZIM),1999-2004,20,32,14,14,0,0,14,2 (2ct 0st),0.43700000000000006,
48,SP Gupte (INDIA),1951-1961,36,61,14,14,0,0,14,2 (2ct 0st),0.22899999999999998,
49,CZ Harris (NZ),1992-2002,23,38,14,14,0,0,14,3 (3ct 0st),0.368,
0,GA Headley (WI),1930-1954,22,38,14,14,0,0,14,2 (2ct 0st),0.368,
1,CJ Jordan (ENG),2014-2015,8,16,14,14,0,0,14,3 (3ct 0st),0.875,
2,BD Julien (WI),1973-1977,24,46,14,14,0,0,14,2 (2ct 0st),0.304,
3,M Kaif (INDIA),2000-2006,13,24,14,14,0,0,14,4 (4ct 0st),0.583,
4,BR Knight (ENG),1961-1969,29,55,14,14,0,0,14,2 (2ct 0st),0.254,
5,BW Luckhurst (ENG),1970-1974,21,39,14,14,0,0,14,2 (2ct 0st),0.358,
6,CL McCool (AUS),1946-1950,14,27,14,14,0,0,14,1 (1ct 0st),0.518,
7,CC McDonald (AUS),1952-1961,47,90,14,14,0,0,14,2 (2ct 0st),0.155,
8,AA Mailey (AUS),1920-1926,21,38,14,14,0,0,14,2 (2ct 0st),0.368,
9,CS Martin (NZ),2000-2013,71,128,14,14,0,0,14,1 (1ct 0st),0.109,
10,Mohammad Rizwan (PAK),2016-2019,5,7,14,14,0,13,1,4 (4ct 0st),2.0,
11,DK Morrison (NZ),1987-1997,48,76,14,14,0,0,14,2 (2ct 0st),0.184,
12,R Pilling (ENG),1881-1888,8,14,14,10,4,10,0,3 (1ct 2st),1.0,
13,AE Relf (ENG),1903-1914,13,25,14,14,0,0,14,2 (2ct 0st),0.56,
14,GM Ritchie (AUS),1982-1987,30,48,14,14,0,0,14,2 (2ct 0st),0.29100000000000004,
15,EAB Rowan (SA),1935-1951,26,43,14,14,0,0,14,2 (2ct 0st),0.325,
16,MJ Santner (NZ),2015-2019,22,42,14,14,0,0,14,1 (1ct 0st),0.33299999999999996,
17,Tamim Iqbal (BDESH),2008-2019,58,100,14,14,0,0,14,2 (2ct 0st),0.14,
18,CB van Ryneveld (SA),1951-1958,19,35,14,14,0,0,14,2 (2ct 0st),0.4,
19,SM Warnapura (SL),2007-2009,14,26,14,14,0,0,14,2 (2ct 0st),0.5379999999999999,
20,C White (ENG),1994-2002,30,53,14,14,0,0,14,3 (3ct 0st),0.264,
21,NWD Yardley (ENG),1938-1950,20,36,14,14,0,0,14,2 (2ct 0st),0.38799999999999996,
22,R Abel (ENG),1888-1902,13,26,13,13,0,0,13,3 (3ct 0st),0.5,
23,L Amarnath (INDIA),1933-1952,24,38,13,13,0,5,8,3 (3ct 0st),0.342,
24,J Arun Lal (INDIA),1982-1989,16,30,13,13,0,0,13,2 (2ct 0st),0.433,
25,CWJ Athey (ENG),1980-1988,23,38,13,13,0,0,13,2 (2ct 0st),0.342,
26,DL Bairstow (ENG),1979-1981,4,7,13,12,1,12,0,4 (4ct 0st),1.857,
27,AB Barath (WI),2009-2012,15,27,13,13,0,0,13,3 (3ct 0st),0.48100000000000004,
28,AM Blignaut (ZIM),2001-2005,19,31,13,13,0,0,13,3 (3ct 0st),0.419,
29,RJ Bright (AUS),1977-1986,25,42,13,13,0,0,13,1 (1ct 0st),0.309,
30,HD Bromfield (SA),1961-1965,9,18,13,13,0,0,13,2 (2ct 0st),0.722,
31,MC Carew (WI),1963-1972,19,35,13,13,0,0,13,3 (3ct 0st),0.371,
32,JE Cheetham (SA),1949-1955,24,43,13,13,0,0,13,3 (3ct 0st),0.302,
33,HL Collins (AUS),1920-1926,19,35,13,13,0,0,13,2 (2ct 0st),0.371,
34,JN Crawford (ENG),1906-1908,12,23,13,13,0,0,13,3 (3ct 0st),0.565,
35,D Dasgupta (INDIA),2001-2002,8,15,13,13,0,13,0,3 (3ct 0st),0.866,
36,JHW Fingleton (AUS),1932-1938,18,33,13,13,0,0,13,2 (2ct 0st),0.39299999999999996,
37,RE Foster (ENG),1903-1907,8,16,13,13,0,0,13,2 (2ct 0st),0.812,
38,G Geary (ENG),1924-1934,14,24,13,13,0,0,13,2 (2ct 0st),0.541,
39,HM Goonatilleke (SL),1982-1982,5,9,13,10,3,10,0,4 (3ct 1st),1.444,
40,D Gough (ENG),1994-2003,58,99,13,13,0,0,13,2 (2ct 0st),0.131,
41,RS Grant (WI),1935-1939,7,14,13,13,0,0,13,3 (3ct 0st),0.9279999999999999,
42,RJ Harris (AUS),2010-2015,27,52,13,13,0,0,13,2 (2ct 0st),0.25,
43,JW Hearne (ENG),1911-1926,24,42,13,13,0,0,13,2 (2ct 0st),0.309,
44,AMJ Hilditch (AUS),1979-1985,18,28,13,13,0,0,13,2 (2ct 0st),0.46399999999999997,
45,AF Kippax (AUS),1925-1934,22,43,13,13,0,0,13,1 (1ct 0st),0.302,
46,M Labuschagne (AUS),2018-2019,13,25,13,13,0,0,13,3 (3ct 0st),0.52,
47,M Leyland (ENG),1928-1938,41,75,13,13,0,0,13,2 (2ct 0st),0.17300000000000001,
48,AR MacGibbon (NZ),1951-1958,26,38,13,13,0,0,13,2 (2ct 0st),0.342,
49,Maqsood Ahmed (PAK),1952-1955,16,27,13,13,0,0,13,2 (2ct 0st),0.48100000000000004,
0,DPB Morkel (SA),1927-1932,16,28,13,13,0,0,13,2 (2ct 0st),0.46399999999999997,
1,DJ Nash (NZ),1992-2001,32,56,13,13,0,0,13,2 (2ct 0st),0.23199999999999998,
2,GE Palmer (AUS),1880-1886,17,30,13,13,0,0,13,2 (2ct 0st),0.433,
3,JS Patel (NZ),2006-2017,24,43,13,13,0,0,13,3 (3ct 0st),0.302,
4,KS Ranjitsinhji (ENG),1896-1902,15,26,13,13,0,0,13,2 (2ct 0st),0.5,
5,A Ratra (INDIA),2002-2002,6,11,13,11,2,11,0,3 (2ct 1st),1.181,
6,GJ Rennie (ZIM),1997-2002,23,37,13,13,0,0,13,1 (1ct 0st),0.35100000000000003,
7,KAJ Roach (WI),2009-2019,56,101,13,13,0,0,13,2 (2ct 0st),0.128,
8,Saeed Ahmed (PAK),1958-1973,41,70,13,13,0,0,13,2 (2ct 0st),0.185,
9,CS Serjeant (AUS),1977-1978,12,22,13,13,0,0,13,3 (3ct 0st),0.59,
10,JS Solomon (WI),1958-1965,27,53,13,13,0,0,13,2 (2ct 0st),0.245,
11,AL Valentine (WI),1950-1962,36,70,13,13,0,0,13,1 (1ct 0st),0.185,
12,DJ Vilas (SA),2015-2016,6,10,13,13,0,13,0,4 (4ct 0st),1.3,
13,DF Whatmore (AUS),1979-1979,7,11,13,13,0,0,13,4 (4ct 0st),1.181,
14,CR Woakes (ENG),2013-2019,32,61,13,13,0,0,13,2 (2ct 0st),0.213,
15,J Worrall (AUS),1885-1899,11,19,13,13,0,0,13,3 (3ct 0st),0.684,
16,TJE Andrews (AUS),1921-1926,16,28,12,12,0,0,12,2 (2ct 0st),0.428,
17,W Bardsley (AUS),1909-1926,41,74,12,12,0,0,12,1 (1ct 0st),0.162,
18,SF Barnes (ENG),1901-1914,27,52,12,12,0,0,12,2 (2ct 0st),0.23,
19,WKM Benjamin (WI),1987-1995,21,38,12,12,0,0,12,2 (2ct 0st),0.315,
20,J Briggs (ENG),1884-1899,33,63,12,12,0,0,12,2 (2ct 0st),0.19,
21,G Brown (ENG),1921-1923,7,12,12,9,3,9,0,3 (1ct 2st),1.0,
22,W Bruce (AUS),1885-1895,14,24,12,12,0,0,12,3 (3ct 0st),0.5,
23,RJ Burns (ENG),2018-2019,15,29,12,12,0,0,12,2 (2ct 0st),0.413,
24,RH Catterall (SA),1922-1931,24,41,12,12,0,0,12,3 (3ct 0st),0.292,
25,RK Chauhan (INDIA),1993-1998,21,36,12,12,0,0,12,2 (2ct 0st),0.33299999999999996,
26,AG Cremer (ZIM),2005-2017,19,29,12,12,0,0,12,2 (2ct 0st),0.413,
27,PJ Cummins (AUS),2011-2019,29,55,12,12,0,0,12,2 (2ct 0st),0.218,
28,MH Dekker (ZIM),1993-1996,14,25,12,12,0,0,12,4 (4ct 0st),0.48,
29,BT Foakes (ENG),2018-2019,5,10,12,10,2,10,0,3 (3ct 0st),1.2,
30,JEC Franklin (NZ),2001-2013,31,56,12,12,0,0,12,1 (1ct 0st),0.214,
31,GM Fullerton (SA),1947-1951,7,13,12,10,2,6,4,4 (3ct 1st),0.9229999999999999,
32,EA Halliwell (SA),1892-1902,8,13,12,10,2,10,0,2 (2ct 0st),0.9229999999999999,
33,DW Hookes (AUS),1977-1985,23,42,12,12,0,0,12,2 (2ct 0st),0.285,
34,WP Howell (AUS),1898-1904,18,33,12,12,0,0,12,2 (2ct 0st),0.363,
35,NC Johnson (ZIM),1998-2000,13,21,12,12,0,0,12,3 (3ct 0st),0.5710000000000001,
36,SP Jones (AUS),1882-1888,12,21,12,12,0,0,12,2 (2ct 0st),0.5710000000000001,
37,JC Laker (ENG),1948-1959,46,91,12,12,0,0,12,1 (1ct 0st),0.131,
38,AV Mankad (INDIA),1969-1978,22,43,12,12,0,0,12,2 (2ct 0st),0.27899999999999997,
39,RW Morgan (NZ),1965-1972,20,37,12,12,0,0,12,2 (2ct 0st),0.324,
40,JDS Neesham (NZ),2014-2017,12,24,12,12,0,0,12,3 (3ct 0st),0.5,
41,AD Nourse (SA),1935-1951,34,57,12,12,0,0,12,2 (2ct 0st),0.21,
42,SM Patil (INDIA),1980-1984,29,49,12,12,0,0,12,2 (2ct 0st),0.244,
43,V Rathour (INDIA),1996-1997,6,11,12,12,0,0,12,2 (2ct 0st),1.09,
44,RWV Robins (ENG),1929-1937,19,38,12,12,0,0,12,3 (3ct 0st),0.315,
45,JD Ryder (NZ),2008-2011,18,32,12,12,0,0,12,2 (2ct 0st),0.375,
46,Salman Butt (PAK),2003-2010,33,63,12,12,0,0,12,2 (2ct 0st),0.19,
47,Rev.DS Sheppard (ENG),1950-1963,22,42,12,12,0,0,12,1 (1ct 0st),0.285,
48,Shoaib Akhtar (PAK),1997-2007,46,86,12,12,0,0,12,2 (2ct 0st),0.139,
49,RT Spooner (ENG),1951-1955,7,12,12,10,2,10,0,3 (2ct 1st),1.0,
0,PCR Tufnell (ENG),1990-2001,42,74,12,12,0,0,12,1 (1ct 0st),0.162,
1,Umar Akmal (PAK),2009-2011,16,31,12,12,0,0,12,2 (2ct 0st),0.387,
2,MRJ Veletta (AUS),1987-1990,8,14,12,12,0,0,12,2 (2ct 0st),0.857,
3,N Wagner (NZ),2012-2019,46,87,12,12,0,0,12,1 (1ct 0st),0.13699999999999998,
4,MHN Walker (AUS),1972-1977,34,64,12,12,0,0,12,1 (1ct 0st),0.187,
5,JH Wardle (ENG),1948-1957,28,56,12,12,0,0,12,3 (3ct 0st),0.214,
6,C Washbrook (ENG),1937-1956,37,69,12,12,0,0,12,2 (2ct 0st),0.17300000000000001,
7,JC Watkins (SA),1949-1957,15,28,12,12,0,0,12,3 (3ct 0st),0.428,
8,BW Yuile (NZ),1963-1969,17,29,12,12,0,0,12,2 (2ct 0st),0.413,
9,DS Atkinson (WI),1948-1958,22,43,11,11,0,0,11,2 (2ct 0st),0.255,
10,AM Bacher (SA),1996-1999,19,35,11,11,0,0,11,2 (2ct 0st),0.314,
11,RMH Binny (INDIA),1979-1987,27,47,11,11,0,0,11,1 (1ct 0st),0.23399999999999999,
12,JH Board (ENG),1899-1906,6,11,11,8,3,8,0,2 (2ct 0st),1.0,
13,TB de Bruyn (SA),2017-2019,12,21,11,11,0,0,11,4 (4ct 0st),0.523,
14,CC Depeiaza (WI),1955-1956,5,9,11,7,4,6,1,3 (1ct 2st),1.222,
15,PS de Villiers (SA),1993-1998,18,35,11,11,0,0,11,2 (2ct 0st),0.314,
16,Harry Elliott (ENG),1928-1934,4,8,11,8,3,8,0,3 (3ct 0st),1.375,
17,Fazal Mahmood (PAK),1952-1962,34,56,11,11,0,0,11,1 (1ct 0st),0.196,
18,W Ferguson (WI),1948-1954,8,16,11,11,0,0,11,3 (3ct 0st),0.687,
19,FR Foster (ENG),1911-1912,11,20,11,11,0,0,11,2 (2ct 0st),0.55,
20,Ghulam Ahmed (INDIA),1948-1959,22,37,11,11,0,0,11,1 (1ct 0st),0.297,
21,WW Hall (WI),1958-1969,48,92,11,11,0,0,11,1 (1ct 0st),0.11900000000000001,
22,Hanumant Singh (INDIA),1964-1969,14,25,11,11,0,0,11,2 (2ct 0st),0.44,
23,RI Harford (NZ),1968-1968,3,6,11,11,0,11,0,5 (5ct 0st),1.8330000000000002,
24,VS Hazare (INDIA),1946-1953,30,48,11,11,0,0,11,2 (2ct 0st),0.22899999999999998,
25,AJY Hopkins (AUS),1902-1909,20,38,11,11,0,0,11,2 (2ct 0st),0.289,
26,J Hunter (ENG),1884-1885,5,10,11,8,3,8,0,4 (2ct 2st),1.1,
27,GL Jessop (ENG),1899-1912,18,34,11,11,0,0,11,2 (2ct 0st),0.32299999999999995,
28,Junaid Siddique (BDESH),2008-2012,19,33,11,11,0,0,11,2 (2ct 0st),0.33299999999999996,
29,RWT Key (ENG),2002-2005,15,27,11,11,0,0,11,2 (2ct 0st),0.40700000000000003,
30,DS Lehmann (AUS),1998-2004,27,54,11,11,0,0,11,1 (1ct 0st),0.203,
31,JK Lever (ENG),1976-1986,21,38,11,11,0,0,11,1 (1ct 0st),0.289,
32,P Lever (ENG),1970-1975,17,31,11,11,0,0,11,2 (2ct 0st),0.354,
33,D Lloyd (ENG),1974-1975,9,18,11,11,0,0,11,3 (3ct 0st),0.611,
34,DJ Malan (ENG),2017-2018,15,27,11,11,0,0,11,2 (2ct 0st),0.40700000000000003,
35,EJG Morgan (ENG),2010-2012,16,32,11,11,0,0,11,2 (2ct 0st),0.34299999999999997,
36,BA Murphy (ZIM),2000-2001,11,20,11,11,0,0,11,1 (1ct 0st),0.55,
37,Nasim-ul-Ghani (PAK),1958-1973,29,49,11,11,0,0,11,2 (2ct 0st),0.22399999999999998,
38,MS Nichols (ENG),1930-1939,14,24,11,11,0,0,11,2 (2ct 0st),0.45799999999999996,
39,MHW Papps (NZ),2004-2007,8,14,11,11,0,0,11,2 (2ct 0st),0.785,
40,H Philipson (ENG),1892-1895,5,9,11,8,3,8,0,3 (1ct 2st),1.222,
41,B Reddy (INDIA),1979-1979,4,5,11,9,2,9,0,3 (3ct 0st),2.2,
42,Rubel Hossain (BDESH),2009-2018,26,46,11,11,0,0,11,1 (1ct 0st),0.239,
43,HD Rutherford (NZ),2013-2015,16,31,11,11,0,0,11,3 (3ct 0st),0.354,
44,Saeed Ajmal (PAK),2009-2014,35,67,11,11,0,0,11,2 (2ct 0st),0.16399999999999998,
45,Saleem Elahi (PAK),1995-2003,13,23,11,10,1,0,10,4 (4ct 0st),0.478,
46,Shadab Kabir (PAK),1996-2002,5,9,11,11,0,0,11,3 (3ct 0st),1.222,
47,Shan Masood (PAK),2013-2019,19,33,11,11,0,0,11,2 (2ct 0st),0.33299999999999996,
48,IS Sodhi (NZ),2013-2018,17,33,11,11,0,0,11,2 (2ct 0st),0.33299999999999996,
49,FR Spofforth (AUS),1877-1887,18,31,11,11,0,0,11,3 (3ct 0st),0.354,
0,W Storer (ENG),1897-1899,6,10,11,11,0,11,0,3 (3ct 0st),1.1,
1,BC Strang (ZIM),1995-2001,26,46,11,11,0,0,11,1 (1ct 0st),0.239,
2,MW Tate (ENG),1924-1935,39,68,11,11,0,0,11,2 (2ct 0st),0.161,
3,JM Taylor (AUS),1920-1926,20,37,11,11,0,0,11,1 (1ct 0st),0.297,
4,Umar Gul (PAK),2003-2013,47,91,11,11,0,0,11,2 (2ct 0st),0.12,
5,PL van der Merwe (SA),1963-1967,15,30,11,11,0,0,11,2 (2ct 0st),0.366,
6,M van Jaarsveld (SA),2002-2004,9,17,11,11,0,0,11,2 (2ct 0st),0.647,
7,S Viswanath (INDIA),1985-1985,3,6,11,11,0,11,0,4 (4ct 0st),1.8330000000000002,
8,TW Wall (AUS),1929-1934,18,34,11,11,0,0,11,2 (2ct 0st),0.32299999999999995,
9,PJ Wiseman (NZ),1998-2005,25,48,11,11,0,0,11,2 (2ct 0st),0.22899999999999998,
10,A Wood (ENG),1938-1939,4,7,11,10,1,10,0,2 (2ct 0st),1.571,
11,Yajurvindra Singh (INDIA),1977-1979,4,8,11,11,0,0,11,5 (5ct 0st),1.375,
12,DA Allen (ENG),1960-1966,39,69,10,10,0,0,10,2 (2ct 0st),0.14400000000000002,
13,Al Sahariar (BDESH),2000-2003,15,20,10,10,0,0,10,3 (3ct 0st),0.5,
14,Asim Kamal (PAK),2003-2005,12,23,10,10,0,0,10,2 (2ct 0st),0.434,
15,A Bacher (SA),1965-1970,12,24,10,10,0,0,10,2 (2ct 0st),0.41600000000000004,
16,GJ Bailey (AUS),2013-2014,5,10,10,10,0,0,10,2 (2ct 0st),1.0,
17,KC Bland (SA),1961-1966,21,40,10,10,0,0,10,2 (2ct 0st),0.25,
18,HF Boyle (AUS),1879-1884,12,23,10,10,0,0,10,1 (1ct 0st),0.434,
19,DAJ Bracewell (NZ),2011-2016,27,49,10,10,0,0,10,2 (2ct 0st),0.204,
20,BC Broad (ENG),1984-1989,25,41,10,10,0,0,10,2 (2ct 0st),0.243,
21,ME Chapple (NZ),1953-1966,14,26,10,10,0,0,10,2 (2ct 0st),0.384,
22,RO Collinge (NZ),1965-1978,35,63,10,10,0,0,10,1 (1ct 0st),0.158,
23,RDB Croft (ENG),1996-2001,21,35,10,10,0,0,10,2 (2ct 0st),0.285,
24,WW Davis (WI),1983-1988,15,28,10,10,0,0,10,2 (2ct 0st),0.35700000000000004,
25,OC Dawson (SA),1947-1949,9,17,10,10,0,0,10,3 (3ct 0st),0.588,
26,GR Dilley (ENG),1979-1989,41,66,10,10,0,0,10,2 (2ct 0st),0.151,
27,DR Doshi (INDIA),1979-1983,33,57,10,10,0,0,10,2 (2ct 0st),0.175,
28,KS Duleepsinhji (ENG),1929-1931,12,17,10,10,0,0,10,2 (2ct 0st),0.588,
29,J Dyson (AUS),1977-1984,30,56,10,10,0,0,10,2 (2ct 0st),0.17800000000000002,
30,FH Edwards (WI),2003-2012,55,102,10,10,0,0,10,1 (1ct 0st),0.098,
31,CRD Fernando (SL),2000-2012,40,69,10,10,0,0,10,2 (2ct 0st),0.14400000000000002,
32,DR Flynn (NZ),2008-2013,24,40,10,10,0,0,10,2 (2ct 0st),0.25,
33,G Fowler (ENG),1982-1985,21,39,10,10,0,0,10,1 (1ct 0st),0.256,
34,MW Goodwin (ZIM),1998-2000,19,32,10,10,0,0,10,3 (3ct 0st),0.312,
35,GC Grant (WI),1930-1935,12,18,10,10,0,0,10,2 (2ct 0st),0.555,
36,RE Grieveson (SA),1939-1939,2,4,10,7,3,7,0,3 (3ct 0st),2.5,
37,Haris Sohail (PAK),2017-2019,13,23,10,10,0,0,10,2 (2ct 0st),0.434,
38,TM Head (AUS),2018-2019,16,31,10,10,0,0,10,2 (2ct 0st),0.322,
39,HSTL Hendry (AUS),1921-1929,11,22,10,10,0,0,10,3 (3ct 0st),0.45399999999999996,
40,Hon.FS Jackson (ENG),1893-1905,20,36,10,10,0,0,10,2 (2ct 0st),0.27699999999999997,
41,Javed Omar (BDESH),2001-2007,40,54,10,10,0,0,10,2 (2ct 0st),0.185,
42,DRE Joseph (WI),1999-1999,4,8,10,10,0,0,10,3 (3ct 0st),1.25,
43,RS Kalpage (SL),1993-1999,11,16,10,10,0,0,10,2 (2ct 0st),0.625,
44,GF Lawson (AUS),1980-1989,46,81,10,10,0,0,10,2 (2ct 0st),0.12300000000000001,
45,PA McAlister (AUS),1904-1909,8,16,10,10,0,0,10,2 (2ct 0st),0.625,
46,TG McIntosh (NZ),2008-2011,17,32,10,10,0,0,10,2 (2ct 0st),0.312,
47,CA McWatt (WI),1954-1955,6,11,10,9,1,9,0,3 (3ct 0st),0.909,
48,IL Mendonca (WI),1962-1962,2,4,10,8,2,8,0,3 (2ct 1st),2.5,
49,WE Midwinter (AUS/ENG),1877-1887,12,22,10,10,0,0,10,2 (2ct 0st),0.45399999999999996,
0,Mohammed Shami (INDIA),2013-2019,47,91,10,10,0,0,10,1 (1ct 0st),0.109,
1,PJ Moor (ZIM),2016-2018,8,14,10,9,1,6,3,3 (2ct 1st),0.7140000000000001,
2,MD Moxon (ENG),1986-1989,10,16,10,10,0,0,10,3 (3ct 0st),0.625,
3,Nasir Hossain (BDESH),2011-2017,19,33,10,10,0,0,10,2 (2ct 0st),0.303,
4,PP Ojha (INDIA),2009-2013,24,48,10,10,0,0,10,1 (1ct 0st),0.20800000000000002,
5,HK Olonga (ZIM),1995-2002,30,51,10,10,0,0,10,2 (2ct 0st),0.196,
6,MS Panesar (ENG),2006-2013,50,90,10,10,0,0,10,1 (1ct 0st),0.111,
7,DR Pringle (ENG),1982-1992,30,56,10,10,0,0,10,2 (2ct 0st),0.17800000000000002,
8,KR Pushpakumara (SL),1994-2001,23,39,10,10,0,0,10,3 (3ct 0st),0.256,
9,AF Rae (WI),1948-1953,15,30,10,10,0,0,10,2 (2ct 0st),0.33299999999999996,
10,VS Ransford (AUS),1907-1912,20,39,10,10,0,0,10,2 (2ct 0st),0.256,
11,Shahid Afridi (PAK),1998-2010,27,52,10,10,0,0,10,2 (2ct 0st),0.192,
12,BR Taylor (NZ),1965-1973,30,55,10,10,0,0,10,1 (1ct 0st),0.18100000000000002,
13,PL Taylor (AUS),1987-1991,13,23,10,10,0,0,10,2 (2ct 0st),0.434,
14,EFS Tylecote (ENG),1882-1886,6,12,10,5,5,5,0,3 (1ct 2st),0.833,
15,KDK Vithanage (SL),2013-2015,10,20,10,10,0,0,10,2 (2ct 0st),0.5,
16,MN Waller (ZIM),2011-2017,14,25,10,10,0,0,10,2 (2ct 0st),0.4,
17,CAK Walton (WI),2009-2009,2,4,10,10,0,10,0,5 (5ct 0st),2.5,
18,Waqar Hasan (PAK),1952-1959,21,36,10,10,0,0,10,2 (2ct 0st),0.27699999999999997,
19,S Wettimuny (SL),1982-1987,23,35,10,10,0,0,10,2 (2ct 0st),0.285,
20,GC White (SA),1906-1912,17,31,10,10,0,0,10,2 (2ct 0st),0.322,
21,AGD Wickremasinghe (SL),1989-1992,3,6,10,9,1,9,0,3 (3ct 0st),1.666,
22,RA Woolmer (ENG),1975-1981,19,36,10,10,0,0,10,2 (2ct 0st),0.27699999999999997,
23,DVP Wright (ENG),1938-1951,34,62,10,10,0,0,10,2 (2ct 0st),0.161,
24,NS Yadav (INDIA),1979-1987,35,64,10,10,0,0,10,1 (1ct 0st),0.156,
25,Zulqarnain (PAK),1986-1986,3,6,10,8,2,8,0,3 (3ct 0st),1.666,
26,PK Amre (INDIA),1992-1993,11,21,9,9,0,0,9,2 (2ct 0st),0.428,
27,GG Arnold (ENG),1967-1975,34,61,9,9,0,0,9,2 (2ct 0st),0.147,
28,W Attewell (ENG),1884-1892,10,20,9,9,0,0,9,2 (2ct 0st),0.45,
29,W Bates (ENG),1881-1887,15,29,9,9,0,0,9,1 (1ct 0st),0.31,
30,JM Blanckenberg (SA),1913-1924,18,29,9,9,0,0,9,2 (2ct 0st),0.31,
31,BJT Bosanquet (ENG),1903-1905,7,13,9,9,0,0,9,2 (2ct 0st),0.6920000000000001,
32,G Cook (ENG),1982-1983,7,13,9,9,0,0,9,2 (2ct 0st),0.6920000000000001,
33,NG Cowans (ENG),1982-1985,19,36,9,9,0,0,9,1 (1ct 0st),0.25,
34,IC Davis (AUS),1973-1977,15,28,9,9,0,0,9,2 (2ct 0st),0.321,
35,ALF de Mel (SL),1982-1986,17,27,9,9,0,0,9,2 (2ct 0st),0.33299999999999996,
36,RB Desai (INDIA),1959-1968,28,45,9,9,0,0,9,2 (2ct 0st),0.2,
37,JWHT Douglas (ENG),1911-1925,23,42,9,9,0,0,9,3 (3ct 0st),0.214,
38,T Emmett (ENG),1877-1882,7,13,9,9,0,0,9,3 (3ct 0st),0.6920000000000001,
39,LE Favell (AUS),1954-1961,19,37,9,9,0,0,9,2 (2ct 0st),0.243,
40,DW Fleming (AUS),1994-2001,20,38,9,9,0,0,9,2 (2ct 0st),0.23600000000000002,
41,ARC Fraser (ENG),1989-1998,46,80,9,9,0,0,9,2 (2ct 0st),0.11199999999999999,
42,JH Hampshire (ENG),1969-1975,8,16,9,9,0,0,9,2 (2ct 0st),0.562,
43,J Hardstaff jnr (ENG),1935-1948,23,44,9,9,0,0,9,1 (1ct 0st),0.204,
44,MN Hart (NZ),1994-1995,14,22,9,9,0,0,9,1 (1ct 0st),0.409,
45,NJN Hawke (AUS),1963-1968,27,50,9,9,0,0,9,1 (1ct 0st),0.18,
46,BJ Hodge (AUS),2005-2008,6,12,9,9,0,0,9,2 (2ct 0st),0.75,
47,RIC Holder (WI),1997-1999,11,19,9,9,0,0,9,2 (2ct 0st),0.473,
48,GJ Hopkins (NZ),2008-2010,4,6,9,9,0,9,0,3 (3ct 0st),1.5,
49,KL Hutchings (ENG),1907-1909,7,14,9,9,0,0,9,2 (2ct 0st),0.642,
0,RA Hutton (ENG),1971-1971,5,9,9,9,0,0,9,2 (2ct 0st),1.0,
1,KS Indrajitsinhji (INDIA),1964-1969,4,8,9,6,3,6,0,2 (2ct 0st),1.125,
2,HJ Keith (SA),1953-1957,8,16,9,9,0,0,9,2 (2ct 0st),0.562,
3,LF Kline (AUS),1957-1961,13,25,9,9,0,0,9,2 (2ct 0st),0.36,
4,RA Legall (WI),1953-1953,4,8,9,8,1,8,0,3 (3ct 0st),1.125,
5,SN McGregor (NZ),1955-1965,25,39,9,9,0,0,9,1 (1ct 0st),0.23,
6,CE McLeod (AUS),1894-1905,17,31,9,9,0,0,9,1 (1ct 0st),0.29,
7,RS Madugalle (SL),1982-1988,21,34,9,9,0,0,9,2 (2ct 0st),0.264,
8,Maninder Singh (INDIA),1982-1993,35,57,9,9,0,0,9,1 (1ct 0st),0.157,
9,Mansoor Akhtar (PAK),1980-1990,19,34,9,9,0,0,9,1 (1ct 0st),0.264,
10,MK Mantri (INDIA),1951-1955,4,8,9,8,1,6,2,4 (3ct 1st),1.125,
11,Mashrafe Mortaza (BDESH),2001-2009,36,52,9,9,0,0,9,1 (1ct 0st),0.17300000000000001,
12,I Meckiff (AUS),1957-1963,18,36,9,9,0,0,9,2 (2ct 0st),0.25,
13,LRD Mendis (SL),1982-1988,24,37,9,9,0,0,9,1 (1ct 0st),0.243,
14,A Mitchell (ENG),1933-1936,6,12,9,9,0,0,9,2 (2ct 0st),0.75,
15,TM Moody (AUS),1989-1992,8,13,9,9,0,0,9,2 (2ct 0st),0.6920000000000001,
16,JFM Morrison (NZ),1973-1982,17,29,9,9,0,0,9,2 (2ct 0st),0.31,
17,RC Motz (NZ),1961-1969,32,58,9,9,0,0,9,1 (1ct 0st),0.155,
18,Naushad Ali (PAK),1965-1965,6,11,9,9,0,9,0,3 (3ct 0st),0.818,
19,EP Nupen (SA),1921-1936,17,32,9,9,0,0,9,2 (2ct 0st),0.281,
20,Pervez Sajjad (PAK),1964-1973,19,37,9,9,0,0,9,1 (1ct 0st),0.243,
21,RJ Peterson (SA),2003-2014,15,29,9,9,0,0,9,2 (2ct 0st),0.31,
22,PM Pollock (SA),1961-1970,28,54,9,9,0,0,9,2 (2ct 0st),0.166,
23,Rahat Ali (PAK),2013-2018,21,40,9,9,0,0,9,1 (1ct 0st),0.225,
24,S Ramadhin (WI),1950-1961,43,82,9,9,0,0,9,2 (2ct 0st),0.109,
25,Raqibul Hasan (BDESH),2008-2011,9,17,9,9,0,0,9,2 (2ct 0st),0.529,
26,RJ Ratnayake (SL),1983-1992,23,36,9,9,0,0,9,1 (1ct 0st),0.25,
27,JF Reid (NZ),1979-1986,19,35,9,9,0,0,9,3 (3ct 0st),0.257,
28,AME Roberts (WI),1974-1983,47,90,9,9,0,0,9,1 (1ct 0st),0.1,
29,Shahadat Hossain (BDESH),2005-2015,38,63,9,9,0,0,9,1 (1ct 0st),0.142,
30,S Shillingford (WI),2010-2014,16,29,9,9,0,0,9,1 (1ct 0st),0.31,
31,NS Sidhu (INDIA),1983-1999,51,90,9,9,0,0,9,2 (2ct 0st),0.1,
32,JH Sinclair (SA),1896-1911,25,46,9,9,0,0,9,1 (1ct 0st),0.195,
33,L Sivaramakrishnan (INDIA),1983-1986,9,16,9,9,0,0,9,2 (2ct 0st),0.562,
34,GC Small (ENG),1986-1991,17,32,9,9,0,0,9,2 (2ct 0st),0.281,
35,DR Smith (WI),2004-2006,10,18,9,9,0,0,9,3 (3ct 0st),0.5,
36,OG Smith (WI),1955-1959,26,46,9,9,0,0,9,2 (2ct 0st),0.195,
37,RT Stanyforth (ENG),1927-1928,4,8,9,7,2,7,0,3 (3ct 0st),1.125,
38,GTS Stevens (ENG),1922-1930,10,19,9,9,0,0,9,2 (2ct 0st),0.473,
39,V Subramanya (INDIA),1965-1968,9,15,9,9,0,0,9,3 (3ct 0st),0.6,
40,Taslim Arif (PAK),1980-1980,6,10,9,6,3,6,0,2 (1ct 1st),0.9,
41,Tauseef Ahmed (PAK),1980-1993,34,62,9,9,0,0,9,2 (2ct 0st),0.145,
42,PM Toohey (AUS),1977-1980,15,28,9,9,0,0,9,2 (2ct 0st),0.321,
43,L Tuckett (SA),1947-1949,9,17,9,9,0,0,9,2 (2ct 0st),0.529,
44,PA Wallace (WI),1997-1999,7,13,9,9,0,0,9,2 (2ct 0st),0.6920000000000001,
45,SC Williams (ZIM),2013-2018,10,18,9,9,0,0,9,2 (2ct 0st),0.5,
46,Abdur Rehman (PAK),2007-2014,22,44,8,8,0,0,8,1 (1ct 0st),0.18100000000000002,
47,HR Adhikari (INDIA),1947-1959,21,30,8,8,0,0,8,2 (2ct 0st),0.266,
48,Akram Raza (PAK),1989-1995,9,15,8,8,0,0,8,2 (2ct 0st),0.5329999999999999,
49,Alimuddin (PAK),1954-1962,25,43,8,8,0,0,8,2 (2ct 0st),0.18600000000000003,
0,EG Arnold (ENG),1903-1907,10,19,8,8,0,0,8,2 (2ct 0st),0.42100000000000004,
1,GA Bartlett (NZ),1961-1968,10,18,8,8,0,0,8,1 (1ct 0st),0.444,
2,CA Best (WI),1986-1990,8,16,8,8,0,0,8,2 (2ct 0st),0.5,
3,MG Bevan (AUS),1994-1998,18,36,8,8,0,0,8,2 (2ct 0st),0.222,
4,JG Binks (ENG),1964-1964,2,4,8,8,0,8,0,5 (5ct 0st),2.0,
5,IR Bishop (WI),1989-1998,43,79,8,8,0,0,8,2 (2ct 0st),0.10099999999999999,
6,SE Bond (NZ),2001-2009,18,32,8,8,0,0,8,1 (1ct 0st),0.25,
7,TT Bresnan (ENG),2009-2013,23,43,8,8,0,0,8,1 (1ct 0st),0.18600000000000003,
8,T Campbell (SA),1910-1912,5,9,8,7,1,7,0,2 (2ct 0st),0.888,
9,HB Cave (NZ),1949-1958,19,27,8,8,0,0,8,2 (2ct 0st),0.29600000000000004,
10,BB Chari (ZIM),2014-2018,7,13,8,8,0,3,5,3 (3ct 0st),0.615,
11,WL Cornford (ENG),1930-1930,4,6,8,5,3,5,0,3 (2ct 1st),1.3330000000000002,
12,A Cotter (AUS),1904-1912,21,40,8,8,0,0,8,2 (2ct 0st),0.2,
13,CEH Croft (WI),1977-1982,27,52,8,8,0,0,8,2 (2ct 0st),0.153,
14,LS Darling (AUS),1933-1937,12,23,8,8,0,0,8,3 (3ct 0st),0.34700000000000003,
15,HG Deane (SA),1924-1931,17,27,8,8,0,0,8,2 (2ct 0st),0.29600000000000004,
16,D Denton (ENG),1905-1910,11,21,8,8,0,0,8,2 (2ct 0st),0.38,
17,ST Finn (ENG),2010-2016,36,68,8,8,0,0,8,2 (2ct 0st),0.11699999999999999,
18,TJ Franklin (NZ),1983-1991,21,35,8,8,0,0,8,2 (2ct 0st),0.228,
19,N Gifford (ENG),1964-1973,15,27,8,8,0,0,8,1 (1ct 0st),0.29600000000000004,
20,GJ Gilmour (AUS),1973-1977,15,29,8,8,0,0,8,2 (2ct 0st),0.275,
21,DR Hadlee (NZ),1969-1978,26,45,8,8,0,0,8,2 (2ct 0st),0.177,
22,S Haigh (ENG),1899-1912,11,19,8,8,0,0,8,2 (2ct 0st),0.42100000000000004,
23,AD Hales (ENG),2015-2016,11,21,8,8,0,0,8,2 (2ct 0st),0.38,
24,WK Hegg (ENG),1998-1999,2,4,8,8,0,8,0,3 (3ct 0st),2.0,
25,PS Heine (SA),1955-1962,14,28,8,8,0,0,8,2 (2ct 0st),0.285,
26,RNS Hobbs (ENG),1967-1971,7,12,8,8,0,0,8,2 (2ct 0st),0.6659999999999999,
27,JKC Holt (WI),1954-1959,17,32,8,8,0,0,8,2 (2ct 0st),0.25,
28,Imran Tahir (SA),2011-2015,20,38,8,8,0,0,8,1 (1ct 0st),0.21,
29,DJ Insole (ENG),1950-1957,9,18,8,8,0,0,8,3 (3ct 0st),0.444,
30,Khurram Manzoor (PAK),2009-2014,16,30,8,8,0,0,8,2 (2ct 0st),0.266,
31,PN Kirsten (SA),1992-1994,12,23,8,8,0,0,8,3 (3ct 0st),0.34700000000000003,
32,P Krishnamurthy (INDIA),1971-1971,5,10,8,7,1,7,0,2 (2ct 0st),0.8,
33,KMDN Kulasekara (SL),2005-2014,21,40,8,8,0,0,8,2 (2ct 0st),0.2,
34,B Kumar (INDIA),2013-2018,21,38,8,8,0,0,8,2 (2ct 0st),0.21,
35,CB Lambert (WI),1991-1998,5,10,8,8,0,0,8,3 (3ct 0st),0.8,
36,ACB Langton (SA),1935-1939,15,23,8,8,0,0,8,1 (1ct 0st),0.34700000000000003,
37,W Larkins (ENG),1980-1991,13,22,8,8,0,0,8,2 (2ct 0st),0.363,
38,FJ Laver (AUS),1899-1909,15,28,8,8,0,0,8,1 (1ct 0st),0.285,
39,DM Lewis (WI),1971-1971,3,6,8,8,0,8,0,4 (4ct 0st),1.3330000000000002,
40,TC Lowry (NZ),1930-1931,7,11,8,8,0,0,8,2 (2ct 0st),0.727,
41,A Lyth (ENG),2015-2015,7,13,8,8,0,0,8,2 (2ct 0st),0.615,
42,EL McCormick (AUS),1935-1938,12,22,8,8,0,0,8,2 (2ct 0st),0.363,
43,AJW McIntyre (ENG),1950-1955,3,5,8,8,0,7,1,3 (3ct 0st),1.6,
44,TG McMahon (NZ),1955-1956,5,6,8,7,1,7,0,3 (2ct 1st),1.3330000000000002,
45,Q McMillan (SA),1929-1932,13,23,8,8,0,0,8,2 (2ct 0st),0.34700000000000003,
46,A Melville (SA),1938-1949,11,20,8,8,0,0,8,2 (2ct 0st),0.4,
47,BD Milburn (NZ),1969-1969,3,5,8,6,2,6,0,3 (3ct 0st),1.6,
48,A Mishra (INDIA),2008-2016,22,40,8,8,0,0,8,1 (1ct 0st),0.2,
49,MV Narasimha Rao (INDIA),1978-1979,4,8,8,8,0,0,8,2 (2ct 0st),1.0,
0,Nurul Hasan (BDESH),2017-2018,3,5,8,5,3,5,0,3 (0ct 3st),1.6,
1,IK Pathan (INDIA),2003-2008,29,54,8,8,0,0,8,1 (1ct 0st),0.14800000000000002,
2,DBL Powell (WI),2002-2009,37,68,8,8,0,0,8,2 (2ct 0st),0.11699999999999999,
3,D Ramnarine (WI),1998-2002,12,24,8,8,0,0,8,2 (2ct 0st),0.33299999999999996,
4,JM Read (ENG),1882-1893,17,33,8,8,0,0,8,1 (1ct 0st),0.242,
5,MT Renshaw (AUS),2016-2018,11,21,8,8,0,0,8,1 (1ct 0st),0.38,
6,RT Robinson (ENG),1984-1989,29,49,8,8,0,0,8,1 (1ct 0st),0.163,
7,CAG Russell (ENG),1920-1923,10,16,8,8,0,0,8,3 (3ct 0st),0.5,
8,RG Samuels (WI),1996-1997,6,12,8,8,0,0,8,2 (2ct 0st),0.6659999999999999,
9,HJH Scott (AUS),1884-1886,8,13,8,8,0,0,8,2 (2ct 0st),0.615,
10,Shujauddin (PAK),1954-1962,19,34,8,8,0,0,8,1 (1ct 0st),0.235,
11,Shuvagata Hom (BDESH),2014-2016,8,14,8,8,0,0,8,2 (2ct 0st),0.5710000000000001,
12,BW Sinclair (NZ),1963-1968,21,37,8,8,0,0,8,2 (2ct 0st),0.21600000000000003,
13,GB Studd (ENG),1882-1883,4,8,8,8,0,0,8,3 (3ct 0st),1.0,
14,ML Su'a (NZ),1992-1995,13,22,8,8,0,0,8,2 (2ct 0st),0.363,
15,R Tattersall (ENG),1951-1954,16,30,8,8,0,0,8,2 (2ct 0st),0.266,
16,JE Taylor (WI),2003-2016,46,81,8,8,0,0,8,1 (1ct 0st),0.098,
17,AJ Traicos (SA/ZIM),1970-1993,7,12,8,8,0,0,8,4 (4ct 0st),0.6659999999999999,
18,CTB Turner (AUS),1887-1895,17,30,8,8,0,0,8,2 (2ct 0st),0.266,
19,JM Vince (ENG),2016-2018,13,24,8,8,0,0,8,2 (2ct 0st),0.33299999999999996,
20,W Watson (ENG),1951-1959,23,44,8,8,0,0,8,1 (1ct 0st),0.18100000000000002,
21,AR Whittall (ZIM),1996-1999,10,16,8,8,0,0,8,3 (3ct 0st),0.5,
22,TS Worthington (ENG),1930-1937,9,15,8,8,0,0,8,1 (1ct 0st),0.5329999999999999,
23,RA Young (NZ),2011-2011,5,10,8,8,0,8,0,2 (2ct 0st),0.8,
24,Aftab Ahmed (BDESH),2004-2010,16,23,7,7,0,0,7,2 (2ct 0st),0.304,
25,MA Agarwal (INDIA),2018-2019,9,18,7,7,0,0,7,2 (2ct 0st),0.38799999999999996,
26,JC Alabaster (NZ),1955-1972,21,35,7,7,0,0,7,1 (1ct 0st),0.2,
27,Inshan Ali (WI),1971-1977,12,23,7,7,0,0,7,2 (2ct 0st),0.304,
28,CJ Anderson (NZ),2013-2016,13,25,7,7,0,0,7,2 (2ct 0st),0.28,
29,WE Astill (ENG),1927-1930,9,18,7,7,0,0,7,1 (1ct 0st),0.38799999999999996,
30,Hon.IFW Bligh (ENG),1882-1883,4,8,7,7,0,0,7,2 (2ct 0st),0.875,
31,DJ Brown (ENG),1965-1969,26,46,7,7,0,0,7,2 (2ct 0st),0.152,
32,JT Brown (ENG),1894-1899,8,15,7,7,0,1,6,1 (1ct 0st),0.466,
33,MA Carberry (ENG),2010-2014,6,12,7,7,0,0,7,1 (1ct 0st),0.583,
34,UDU Chandana (SL),1999-2005,16,30,7,7,0,0,7,1 (1ct 0st),0.233,
35,EJ Chatfield (NZ),1975-1989,43,75,7,7,0,0,7,2 (2ct 0st),0.09300000000000001,
36,CM Christiani (WI),1935-1935,4,8,7,6,1,6,0,3 (2ct 1st),0.875,
37,PT Collins (WI),1999-2006,32,61,7,7,0,0,7,1 (1ct 0st),0.114,
38,NRD Compton (ENG),2012-2016,16,29,7,7,0,0,7,2 (2ct 0st),0.24100000000000002,
39,JF Crapp (ENG),1948-1949,7,13,7,7,0,0,7,2 (2ct 0st),0.5379999999999999,
40,Dilawar Hussain (INDIA),1934-1936,3,6,7,6,1,6,0,3 (3ct 0st),1.166,
41,MP Donnelly (NZ),1937-1949,7,12,7,7,0,0,7,2 (2ct 0st),0.583,
42,GN Edwards (NZ),1977-1981,8,13,7,7,0,7,0,3 (3ct 0st),0.5379999999999999,
43,R Edwards (AUS),1972-1975,20,39,7,7,0,0,7,2 (2ct 0st),0.179,
44,SM Ervine (ZIM),2003-2004,5,6,7,7,0,0,7,2 (2ct 0st),1.166,
45,W Farrimond (ENG),1931-1935,4,8,7,5,2,5,0,2 (0ct 2st),0.875,
46,AJ Finch (AUS),2018-2018,5,10,7,7,0,0,7,4 (4ct 0st),0.7,
47,NA Foster (ENG),1983-1993,29,50,7,7,0,0,7,1 (1ct 0st),0.14,
48,GN Francis (WI),1928-1933,10,13,7,7,0,0,7,2 (2ct 0st),0.5379999999999999,
49,KJ Funston (SA),1952-1958,18,34,7,7,0,0,7,2 (2ct 0st),0.205,
0,TW Garrett (AUS),1877-1888,19,34,7,7,0,0,7,1 (1ct 0st),0.205,
1,Hannan Sarkar (BDESH),2002-2004,17,26,7,7,0,0,7,2 (2ct 0st),0.26899999999999996,
2,SJ Harmison (ENG/ICC),2002-2009,63,115,7,7,0,0,7,1 (1ct 0st),0.06,
3,MS Harris (AUS),2018-2019,9,17,7,7,0,0,7,2 (2ct 0st),0.41100000000000003,
4,UC Hathurusingha (SL),1991-1999,26,44,7,7,0,0,7,1 (1ct 0st),0.159,
5,FC Hayes (ENG),1973-1976,9,15,7,7,0,0,7,2 (2ct 0st),0.466,
6,DW Headley (ENG),1997-1999,15,25,7,7,0,0,7,1 (1ct 0st),0.28,
7,SO Hetmyer (WI),2017-2019,16,29,7,7,0,0,7,2 (2ct 0st),0.24100000000000002,
8,BW Hilfenhaus (AUS),2009-2012,27,50,7,7,0,0,7,2 (2ct 0st),0.14,
9,RO Hinds (WI),2002-2009,15,27,7,7,0,0,7,2 (2ct 0st),0.259,
10,RM Hogg (AUS),1978-1984,38,69,7,7,0,0,7,1 (1ct 0st),0.10099999999999999,
11,PM Hornibrook (AUS),1929-1930,6,11,7,7,0,0,7,2 (2ct 0st),0.636,
12,J Humphries (ENG),1908-1908,3,6,7,7,0,7,0,3 (3ct 0st),1.166,
13,Imam-ul-Haq (PAK),2018-2019,11,20,7,7,0,0,7,4 (4ct 0st),0.35,
14,A Jackson (AUS),1929-1931,8,16,7,7,0,0,7,2 (2ct 0st),0.43700000000000006,
15,Jahurul Islam (BDESH),2010-2013,7,13,7,7,0,0,7,2 (2ct 0st),0.5379999999999999,
16,PA Jaques (AUS),2005-2008,11,22,7,7,0,0,7,2 (2ct 0st),0.318,
17,Javed Burki (PAK),1960-1969,25,42,7,7,0,0,7,2 (2ct 0st),0.166,
18,LR Johnson (WI),2014-2016,9,14,7,7,0,0,7,2 (2ct 0st),0.5,
19,SB Joshi (INDIA),1996-2000,15,28,7,7,0,0,7,1 (1ct 0st),0.25,
20,VG Kambli (INDIA),1993-1995,17,30,7,7,0,0,7,1 (1ct 0st),0.233,
21,HR Lance (SA),1962-1970,13,26,7,7,0,0,7,2 (2ct 0st),0.26899999999999996,
22,CB Llewellyn (SA),1896-1912,15,26,7,7,0,0,7,2 (2ct 0st),0.26899999999999996,
23,ML Love (AUS),2002-2003,5,10,7,7,0,0,7,3 (3ct 0st),0.7,
24,SJE Loxton (AUS),1948-1951,12,23,7,7,0,0,7,4 (4ct 0st),0.304,
25,KA Maharaj (SA),2016-2019,28,53,7,7,0,0,7,1 (1ct 0st),0.132,
26,MF Maharoof (SL),2004-2011,22,40,7,7,0,0,7,1 (1ct 0st),0.175,
27,DE Malcolm (ENG),1989-1997,40,73,7,7,0,0,7,1 (1ct 0st),0.095,
28,SL Malinga (SL),2004-2010,30,59,7,7,0,0,7,2 (2ct 0st),0.11800000000000001,
29,Manzoor Elahi (PAK),1984-1995,6,10,7,7,0,0,7,2 (2ct 0st),0.7,
30,XM Marshall (WI),2005-2009,7,14,7,7,0,0,7,2 (2ct 0st),0.5,
31,S Matsikenyeri (ZIM),2003-2005,8,12,7,7,0,0,7,2 (2ct 0st),0.583,
32,TJ Matthews (AUS),1912-1912,8,12,7,7,0,0,7,2 (2ct 0st),0.583,
33,TMK Mawoyo (ZIM),2011-2016,11,20,7,7,0,0,7,2 (2ct 0st),0.35,
34,VM Merchant (INDIA),1933-1951,10,18,7,7,0,0,7,2 (2ct 0st),0.38799999999999996,
35,C Milburn (ENG),1966-1969,9,14,7,7,0,0,7,2 (2ct 0st),0.5,
36,Mohammad Rafique (BDESH),2000-2008,33,48,7,7,0,0,7,1 (1ct 0st),0.145,
37,Mohammad Sami (PAK),2001-2012,36,66,7,7,0,0,7,2 (2ct 0st),0.106,
38,S Mushtaq Ali (INDIA),1934-1952,11,19,7,7,0,0,7,1 (1ct 0st),0.368,
39,Nazar Mohammad (PAK),1952-1952,5,8,7,7,0,0,7,2 (2ct 0st),0.875,
40,ASM Oakman (ENG),1956-1956,2,4,7,7,0,0,7,3 (3ct 0st),1.75,
41,IE O'Brien (NZ),2005-2009,22,38,7,7,0,0,7,2 (2ct 0st),0.184,
42,WJ O'Reilly (AUS),1932-1946,27,50,7,7,0,0,7,2 (2ct 0st),0.14,
43,HH Pandya (INDIA),2017-2018,11,21,7,7,0,0,7,1 (1ct 0st),0.33299999999999996,
44,E Paynter (ENG),1931-1939,20,37,7,7,0,0,7,1 (1ct 0st),0.18899999999999997,
45,JSE Price (ENG),1964-1972,15,28,7,7,0,0,7,2 (2ct 0st),0.25,
46,AMB Rowan (SA),1947-1951,15,28,7,7,0,0,7,2 (2ct 0st),0.25,
47,Sami Aslam (PAK),2015-2017,13,25,7,7,0,0,7,2 (2ct 0st),0.28,
48,VJ Scott (NZ),1946-1952,10,14,7,7,0,0,7,2 (2ct 0st),0.5,
49,JED Sealy (WI),1930-1939,11,21,7,6,1,4,2,2 (1ct 1st),0.33299999999999996,
0,Shamsur Rahman (BDESH),2014-2014,6,11,7,7,0,0,7,2 (2ct 0st),0.636,
1,C Sharma (INDIA),1984-1989,23,40,7,7,0,0,7,1 (1ct 0st),0.175,
2,M Sherwin (ENG),1887-1888,3,6,7,5,2,5,0,4 (2ct 2st),1.166,
3,IJ Siedle (SA),1928-1936,18,29,7,7,0,0,7,2 (2ct 0st),0.24100000000000002,
4,Sikander Bakht (PAK),1976-1983,26,48,7,7,0,0,7,1 (1ct 0st),0.145,
5,LPC Silva (SL),2006-2008,11,21,7,7,0,0,7,2 (2ct 0st),0.33299999999999996,
6,MC Snedden (NZ),1981-1990,25,42,7,7,0,0,7,2 (2ct 0st),0.166,
7,DS Steele (ENG),1975-1976,8,16,7,7,0,0,7,2 (2ct 0st),0.43700000000000006,
8,JWA Taylor (ENG),2012-2016,7,13,7,7,0,0,7,2 (2ct 0st),0.5379999999999999,
9,SA Thomson (NZ),1990-1995,19,31,7,7,0,0,7,1 (1ct 0st),0.225,
10,EWT Tindill (NZ),1937-1947,5,8,7,6,1,6,0,2 (2ct 0st),0.875,
11,PHJ Trimborn (SA),1967-1970,4,8,7,7,0,0,7,2 (2ct 0st),0.875,
12,TR Veivers (AUS),1963-1967,21,38,7,7,0,0,7,2 (2ct 0st),0.184,
13,Wajahatullah Wasti (PAK),1999-2000,6,10,7,7,0,0,7,3 (3ct 0st),0.7,
14,WW Whysall (ENG),1925-1930,4,7,7,7,0,0,7,2 (2ct 0st),1.0,
15,WM Woodfull (AUS),1926-1934,35,65,7,7,0,0,7,2 (2ct 0st),0.107,
16,RD Woolley (AUS),1983-1984,2,3,7,7,0,7,0,3 (3ct 0st),2.333,
17,EE Achong (WI),1930-1935,6,9,6,6,0,0,6,1 (1ct 0st),0.6659999999999999,
18,CJ Adams (ENG),1999-2000,5,7,6,6,0,0,6,3 (3ct 0st),0.857,
19,Afsar Zazai (AFG),2018-2019,3,5,6,5,1,5,0,2 (2ct 0st),1.2,
20,AB Agarkar (INDIA),1998-2006,26,48,6,6,0,0,6,1 (1ct 0st),0.125,
21,HK Badani (INDIA),2001-2001,4,7,6,6,0,0,6,2 (2ct 0st),0.857,
22,AA Baig (INDIA),1959-1967,10,17,6,6,0,0,6,1 (1ct 0st),0.35200000000000004,
23,OAC Banks (WI),2003-2005,10,20,6,6,0,0,6,3 (3ct 0st),0.3,
24,Basit Ali (PAK),1993-1995,19,35,6,6,0,0,6,1 (1ct 0st),0.171,
25,AJ Bell (SA),1929-1935,16,27,6,6,0,0,6,1 (1ct 0st),0.222,
26,TL Best (WI),2003-2013,25,46,6,6,0,0,6,1 (1ct 0st),0.13,
27,C Blythe (ENG),1901-1910,19,37,6,6,0,0,6,1 (1ct 0st),0.162,
28,RS Bopara (ENG),2007-2012,13,20,6,6,0,0,6,2 (2ct 0st),0.3,
29,GE Bradburn (NZ),1990-2001,7,11,6,6,0,0,6,2 (2ct 0st),0.545,
30,W Brockwell (ENG),1893-1899,7,13,6,6,0,0,6,1 (1ct 0st),0.461,
31,SSJ Brooks (WI),2019-2019,3,6,6,6,0,0,6,2 (2ct 0st),1.0,
32,DJ Capel (ENG),1987-1990,15,24,6,6,0,0,6,2 (2ct 0st),0.25,
33,W Carkeek (AUS),1912-1912,6,9,6,6,0,6,0,2 (2ct 0st),0.6659999999999999,
34,E Chigumbura (ZIM),2004-2014,14,24,6,6,0,0,6,2 (2ct 0st),0.25,
35,WM Clark (AUS),1977-1979,10,18,6,6,0,0,6,1 (1ct 0st),0.33299999999999996,
36,CD Collymore (WI),1999-2007,30,58,6,6,0,0,6,1 (1ct 0st),0.10300000000000001,
37,SC Cook (SA),2016-2017,11,20,6,6,0,0,6,2 (2ct 0st),0.3,
38,V Dahiya (INDIA),2000-2000,2,4,6,6,0,6,0,3 (3ct 0st),1.5,
39,RL Dias (SL),1982-1987,20,30,6,6,0,0,6,2 (2ct 0st),0.2,
40,AIC Dodemaide (AUS),1987-1992,10,17,6,6,0,0,6,2 (2ct 0st),0.35200000000000004,
41,PA Emery (AUS),1994-1994,1,2,6,5,1,5,0,5 (4ct 1st),3.0,
42,FL Fane (ENG),1906-1910,14,27,6,6,0,0,6,1 (1ct 0st),0.222,
43,CV Gadkari (INDIA),1953-1955,6,10,6,6,0,0,6,3 (3ct 0st),0.6,
44,DRA Gehrs (AUS),1904-1911,6,11,6,6,0,0,6,2 (2ct 0st),0.545,
45,Y Goonasekera (SL),1983-1983,2,3,6,6,0,0,6,4 (4ct 0st),2.0,
46,AH Gray (WI),1986-1987,5,10,6,6,0,0,6,3 (3ct 0st),0.6,
47,EJ Gray (NZ),1983-1988,10,17,6,6,0,0,6,2 (2ct 0st),0.35200000000000004,
48,DAS Gunaratne (SL),2016-2017,6,12,6,6,0,0,6,2 (2ct 0st),0.5,
49,MD Gunathilaka (SL),2017-2018,8,15,6,6,0,0,6,1 (1ct 0st),0.4,
0,WA Hadlee (NZ),1937-1951,11,17,6,6,0,0,6,2 (2ct 0st),0.35200000000000004,
1,PGZ Harris (NZ),1955-1965,9,15,6,6,0,0,6,3 (3ct 0st),0.4,
2,TP Horan (AUS),1877-1885,15,28,6,6,0,0,6,1 (1ct 0st),0.214,
3,HV Hordern (AUS),1911-1912,7,13,6,6,0,0,6,2 (2ct 0st),0.461,
4,AS Joseph (WI),2016-2019,9,17,6,6,0,0,6,1 (1ct 0st),0.35200000000000004,
5,SMS Kaluperuma (SL),1984-1988,4,6,6,6,0,0,6,2 (2ct 0st),1.0,
6,CK Kapugedera (SL),2006-2009,8,15,6,6,0,0,6,2 (2ct 0st),0.4,
7,MF Kent (AUS),1981-1981,3,6,6,6,0,0,6,3 (3ct 0st),1.0,
8,R Kilner (ENG),1924-1926,9,13,6,6,0,0,6,2 (2ct 0st),0.461,
9,James Langridge (ENG),1933-1946,8,15,6,6,0,0,6,2 (2ct 0st),0.4,
10,CN McCarthy (SA),1948-1951,15,26,6,6,0,0,6,1 (1ct 0st),0.23,
11,PS McDonnell (AUS),1880-1888,19,34,6,6,0,0,6,2 (2ct 0st),0.17600000000000002,
12,PJ Martin (ENG),1995-1997,8,13,6,6,0,0,6,1 (1ct 0st),0.461,
13,TBA May (AUS),1987-1995,24,46,6,6,0,0,6,1 (1ct 0st),0.13,
14,Mehrab Hossain (BDESH),2000-2003,9,11,6,6,0,2,4,2 (2ct 0st),0.545,
15,CR Miller (AUS),1998-2001,18,34,6,6,0,0,6,1 (1ct 0st),0.17600000000000002,
16,FM Misson (AUS),1960-1961,5,10,6,6,0,0,6,2 (2ct 0st),0.6,
17,Mohammad Ilyas (PAK),1964-1969,10,19,6,6,0,0,6,2 (2ct 0st),0.315,
18,A Mukund (INDIA),2011-2017,7,14,6,6,0,0,6,2 (2ct 0st),0.428,
19,AD Mullally (ENG),1996-2001,19,34,6,6,0,0,6,1 (1ct 0st),0.17600000000000002,
20,DJ Murray (NZ),1994-1995,8,14,6,6,0,0,6,2 (2ct 0st),0.428,
21,Mushfiqur Rahman (BDESH),2001-2004,10,15,6,6,0,0,6,2 (2ct 0st),0.4,
22,Nadeem Abbasi (PAK),1989-1989,3,5,6,6,0,6,0,2 (2ct 0st),1.2,
23,KK Nair (INDIA),2016-2017,6,12,6,6,0,0,6,2 (2ct 0st),0.5,
24,BP Nash (WI),2008-2011,21,37,6,6,0,0,6,1 (1ct 0st),0.162,
25,LJ Nash (AUS),1932-1937,2,4,6,6,0,0,6,2 (2ct 0st),1.5,
26,SB O'Connor (NZ),1997-2001,19,35,6,6,0,0,6,2 (2ct 0st),0.171,
27,ML Page (NZ),1930-1937,14,22,6,6,0,0,6,2 (2ct 0st),0.272,
28,BH Pairaudeau (WI),1953-1957,13,25,6,6,0,0,6,1 (1ct 0st),0.24,
29,JT Partridge (SA),1963-1965,11,20,6,6,0,0,6,1 (1ct 0st),0.3,
30,MM Patel (INDIA),2006-2011,13,25,6,6,0,0,6,2 (2ct 0st),0.24,
31,KR Patterson (AUS),2019-2019,2,4,6,6,0,0,6,2 (2ct 0st),1.5,
32,DB Pithey (SA),1963-1967,8,16,6,6,0,0,6,2 (2ct 0st),0.375,
33,BKV Prasad (INDIA),1996-2001,33,59,6,6,0,0,6,1 (1ct 0st),0.10099999999999999,
34,KTGD Prasad (SL),2008-2015,25,47,6,6,0,0,6,2 (2ct 0st),0.127,
35,SLV Raju (INDIA),1990-2001,28,52,6,6,0,0,6,1 (1ct 0st),0.115,
36,WV Raman (INDIA),1988-1997,11,21,6,6,0,0,6,2 (2ct 0st),0.285,
37,CPH Ramanayake (SL),1988-1993,18,30,6,6,0,0,6,1 (1ct 0st),0.2,
38,FL Reifer (WI),1997-2009,6,12,6,6,0,0,6,2 (2ct 0st),0.5,
39,PE Richardson (ENG),1956-1963,34,65,6,6,0,0,6,1 (1ct 0st),0.092,
40,JDB Robertson (ENG),1947-1952,11,19,6,6,0,0,6,1 (1ct 0st),0.315,
41,PADLR Sandakan (SL),2016-2018,11,21,6,6,0,0,6,1 (1ct 0st),0.285,
42,S Shivnarine (WI),1978-1979,8,13,6,6,0,0,6,2 (2ct 0st),0.461,
43,JM Sims (ENG),1935-1937,4,8,6,6,0,0,6,3 (3ct 0st),0.75,
44,RP Singh (INDIA),2006-2011,14,25,6,6,0,0,6,1 (1ct 0st),0.24,
45,MJ Stewart (ENG),1962-1964,8,16,6,6,0,0,6,2 (2ct 0st),0.375,
46,AE Stoddart (ENG),1888-1898,16,29,6,6,0,0,6,1 (1ct 0st),0.20600000000000002,
47,Tapash Baisya (BDESH),2002-2005,21,29,6,6,0,0,6,1 (1ct 0st),0.20600000000000002,
48,Lord Tennyson (ENG),1913-1921,9,16,6,6,0,0,6,2 (2ct 0st),0.375,
49,TL Tsolekile (SA),2004-2004,3,5,6,6,0,6,0,3 (3ct 0st),1.2,
0,MG Vandort (SL),2001-2008,20,39,6,6,0,0,6,1 (1ct 0st),0.153,
1,S van Zyl (SA),2014-2016,12,20,6,6,0,0,6,1 (1ct 0st),0.3,
2,MA Vermeulen (ZIM),2002-2014,9,14,6,6,0,0,6,1 (1ct 0st),0.428,
3,CF Walters (ENG),1933-1934,11,21,6,6,0,0,6,2 (2ct 0st),0.285,
4,JC White (ENG),1921-1931,15,29,6,6,0,0,6,1 (1ct 0st),0.20600000000000002,
5,GC Wilson (IRE),2018-2019,2,4,6,6,0,6,0,3 (3ct 0st),1.5,
6,B Wood (ENG),1972-1978,12,23,6,6,0,0,6,2 (2ct 0st),0.26,
7,GEC Wood (ENG),1924-1924,3,6,6,5,1,5,0,2 (2ct 0st),1.0,
8,RA Young (ENG),1907-1908,2,4,6,6,0,6,0,2 (2ct 0st),1.5,
9,Alok Kapali (BDESH),2002-2006,17,25,5,5,0,0,5,2 (2ct 0st),0.2,
10,Aminul Islam (BDESH),2000-2002,13,16,5,5,0,0,5,3 (3ct 0st),0.312,
11,Asif Masood (PAK),1969-1977,16,29,5,5,0,0,5,1 (1ct 0st),0.172,
12,Atiq-uz-Zaman (PAK),2000-2000,1,2,5,5,0,5,0,3 (3ct 0st),2.5,
13,XC Balaskas (SA),1930-1939,9,14,5,5,0,0,5,1 (1ct 0st),0.35700000000000004,
14,BA Barnett (AUS),1938-1938,4,6,5,3,2,3,0,3 (2ct 1st),0.833,
15,MJ Bennett (AUS),1984-1985,3,5,5,5,0,0,5,1 (1ct 0st),1.0,
16,MC Bird (ENG),1910-1914,10,20,5,5,0,0,5,3 (3ct 0st),0.25,
17,RW Blair (NZ),1953-1964,19,28,5,5,0,0,5,1 (1ct 0st),0.17800000000000002,
18,RC Blunt (NZ),1930-1932,9,14,5,5,0,0,5,2 (2ct 0st),0.35700000000000004,
19,KD Boyce (WI),1971-1976,21,41,5,5,0,0,5,1 (1ct 0st),0.121,
20,NGB Cook (ENG),1983-1989,15,25,5,5,0,0,5,2 (2ct 0st),0.2,
21,RRS Cornwall (WI),2019-2019,2,4,5,5,0,0,5,2 (2ct 0st),1.25,
22,CS Cowdrey (ENG),1984-1988,6,12,5,5,0,0,5,2 (2ct 0st),0.41600000000000004,
23,CE Cuffy (WI),1994-2002,15,26,5,5,0,0,5,1 (1ct 0st),0.192,
24,SH Curnow (SA),1930-1932,7,11,5,5,0,0,5,3 (3ct 0st),0.45399999999999996,
25,OC da Costa (WI),1930-1935,5,7,5,5,0,0,5,3 (3ct 0st),0.7140000000000001,
26,EL Dalton (SA),1929-1939,15,26,5,5,0,0,5,2 (2ct 0st),0.192,
27,WM Darling (AUS),1978-1979,14,25,5,5,0,0,5,2 (2ct 0st),0.2,
28,JL Denly (ENG),2019-2019,11,21,5,5,0,0,5,1 (1ct 0st),0.23800000000000002,
29,AM de Silva (SL),1993-1993,3,4,5,4,1,4,0,2 (2ct 0st),1.25,
30,DS de Silva (SL),1982-1984,12,19,5,5,0,0,5,2 (2ct 0st),0.263,
31,KSC de Silva (SL),1997-1999,8,14,5,5,0,0,5,2 (2ct 0st),0.35700000000000004,
32,RV Divecha (INDIA),1951-1952,5,7,5,5,0,0,5,2 (2ct 0st),0.7140000000000001,
33,TM Dowlin (WI),2009-2010,6,11,5,5,0,0,5,2 (2ct 0st),0.45399999999999996,
34,NF Druce (ENG),1897-1898,5,8,5,5,0,1,4,2 (2ct 0st),0.625,
35,CE Eksteen (SA),1993-2000,7,14,5,5,0,0,5,1 (1ct 0st),0.35700000000000004,
36,RMS Eranga (SL),2011-2016,19,36,5,5,0,0,5,1 (1ct 0st),0.138,
37,E Evans (AUS),1881-1886,6,10,5,5,0,0,5,2 (2ct 0st),0.5,
38,AE Fagg (ENG),1936-1939,5,10,5,5,0,0,5,2 (2ct 0st),0.5,
39,N Pradeep (SL),2011-2017,28,53,5,5,0,0,5,1 (1ct 0st),0.094,
40,FGJ Ford (ENG),1894-1895,5,9,5,5,0,0,5,2 (2ct 0st),0.555,
41,CM Francois (SA),1922-1923,5,10,5,5,0,0,5,3 (3ct 0st),0.5,
42,EW Freeman (AUS),1968-1970,11,21,5,5,0,0,5,1 (1ct 0st),0.23800000000000002,
43,DK Gaekwad (INDIA),1952-1961,11,17,5,5,0,0,5,1 (1ct 0st),0.294,
44,D Gamsy (SA),1970-1970,2,4,5,5,0,5,0,3 (3ct 0st),1.25,
45,AE Greenidge (WI),1978-1979,6,10,5,5,0,0,5,2 (2ct 0st),0.5,
46,AFG Griffith (WI),1997-2000,14,24,5,5,0,0,5,1 (1ct 0st),0.20800000000000002,
47,SC Griffith (ENG),1948-1949,3,6,5,5,0,5,0,3 (3ct 0st),0.833,
48,W Gunn (ENG),1887-1899,11,21,5,5,0,0,5,2 (2ct 0st),0.23800000000000002,
49,JN Hamilton (WI),2019-2019,1,2,5,5,0,5,0,3 (3ct 0st),2.5,
0,BR Hartland (NZ),1992-1994,9,15,5,5,0,0,5,3 (3ct 0st),0.33299999999999996,
1,Hasan Raza (PAK),1996-2005,7,13,5,5,0,0,5,2 (2ct 0st),0.384,
2,CMH Hathorn (SA),1902-1911,12,23,5,5,0,0,5,1 (1ct 0st),0.217,
3,EE Hemmings (ENG),1982-1991,16,28,5,5,0,0,5,1 (1ct 0st),0.17800000000000002,
4,MJ Henry (NZ),2015-2019,11,21,5,5,0,0,5,2 (2ct 0st),0.23800000000000002,
5,ND Hirwani (INDIA),1988-1996,17,31,5,5,0,0,5,1 (1ct 0st),0.161,
6,RG Holland (AUS),1984-1986,11,18,5,5,0,0,5,2 (2ct 0st),0.27699999999999997,
7,DT Hondo (ZIM),2001-2005,9,13,5,5,0,0,5,2 (2ct 0st),0.384,
8,EAC Hunte (WI),1930-1930,3,6,5,5,0,5,0,3 (3ct 0st),0.833,
9,Ijaz Butt (PAK),1959-1962,8,13,5,5,0,2,3,2 (2ct 0st),0.384,
10,Ikram Alikhil (AFG),2019-2019,1,2,5,4,1,4,0,3 (2ct 1st),2.5,
11,RK Illingworth (ENG),1991-1995,9,14,5,5,0,0,5,2 (2ct 0st),0.35700000000000004,
12,A Jadeja (INDIA),1992-2000,15,25,5,5,0,0,5,2 (2ct 0st),0.2,
13,TJ Jenner (AUS),1970-1975,9,18,5,5,0,0,5,2 (2ct 0st),0.27699999999999997,
14,CB Jennings (AUS),1912-1912,6,9,5,5,0,0,5,2 (2ct 0st),0.555,
15,VWC Jupp (ENG),1921-1928,8,15,5,5,0,0,5,1 (1ct 0st),0.33299999999999996,
16,AS Kennedy (ENG),1922-1923,5,9,5,5,0,0,5,2 (2ct 0st),0.555,
17,D Kenyon (ENG),1951-1955,8,15,5,5,0,0,5,2 (2ct 0st),0.33299999999999996,
18,CL King (WI),1976-1980,9,17,5,5,0,0,5,2 (2ct 0st),0.294,
19,FM King (WI),1953-1956,14,26,5,5,0,0,5,2 (2ct 0st),0.192,
20,R Lamba (INDIA),1986-1987,4,7,5,5,0,0,5,3 (3ct 0st),0.7140000000000001,
21,GR Larsen (NZ),1994-1996,8,15,5,5,0,0,5,2 (2ct 0st),0.33299999999999996,
22,JDF Larter (ENG),1962-1965,10,20,5,5,0,0,5,2 (2ct 0st),0.25,
23,RT Latham (NZ),1992-1993,4,8,5,5,0,0,5,2 (2ct 0st),0.625,
24,MJ Leach (ENG),2018-2019,10,19,5,5,0,0,5,1 (1ct 0st),0.263,
25,JD Lindsay (SA),1947-1947,3,6,5,4,1,4,0,2 (1ct 1st),0.833,
26,FA Lowson (ENG),1951-1955,7,12,5,5,0,0,5,2 (2ct 0st),0.41600000000000004,
27,GG Macaulay (ENG),1923-1933,8,14,5,5,0,0,5,1 (1ct 0st),0.35700000000000004,
28,PE McEwan (NZ),1980-1984,4,8,5,5,0,0,5,2 (2ct 0st),0.625,
29,NAM McLean (WI),1998-2001,19,33,5,5,0,0,5,1 (1ct 0st),0.151,
30,EDAS McMorris (WI),1958-1966,13,25,5,5,0,0,5,1 (1ct 0st),0.2,
31,Mahmood Hussain (PAK),1952-1962,27,45,5,5,0,0,5,1 (1ct 0st),0.111,
32,JAH Marshall (NZ),2005-2008,7,13,5,5,0,0,5,1 (1ct 0st),0.384,
33,JW Martin (AUS),1960-1967,8,16,5,5,0,0,5,3 (3ct 0st),0.312,
34,EA Martindale (WI),1933-1939,10,17,5,5,0,0,5,1 (1ct 0st),0.294,
35,HH Massie (AUS),1881-1885,9,17,5,5,0,0,5,1 (1ct 0st),0.294,
36,GJ Maxwell (AUS),2013-2017,7,12,5,5,0,0,5,2 (2ct 0st),0.41600000000000004,
37,CA Milton (ENG),1958-1959,6,12,5,5,0,0,5,2 (2ct 0st),0.41600000000000004,
38,Mohammad Abbas (PAK),2017-2019,17,31,5,5,0,0,5,2 (2ct 0st),0.161,
39,Mohammad Amir (PAK),2009-2019,36,69,5,5,0,0,5,1 (1ct 0st),0.07200000000000001,
40,Mohammad Sharif (BDESH),2001-2007,10,12,5,5,0,0,5,2 (2ct 0st),0.41600000000000004,
41,CH Morris (SA),2016-2017,4,8,5,5,0,0,5,2 (2ct 0st),0.625,
42,A Nehra (INDIA),1999-2004,17,30,5,5,0,0,5,1 (1ct 0st),0.166,
43,AD Ogilvie (AUS),1977-1978,5,10,5,5,0,0,5,1 (1ct 0st),0.5,
44,NV Ojha (INDIA),2015-2015,1,2,5,4,1,4,0,3 (2ct 1st),2.5,
45,GAE Paine (ENG),1935-1935,4,7,5,5,0,0,5,2 (2ct 0st),0.7140000000000001,
46,AY Patel (NZ),2018-2019,7,13,5,5,0,0,5,2 (2ct 0st),0.384,
47,BP Patterson (WI),1986-1992,28,54,5,5,0,0,5,1 (1ct 0st),0.092,
48,JL Pattinson (AUS),2011-2019,20,38,5,5,0,0,5,1 (1ct 0st),0.131,
49,TRO Payne (WI),1986-1986,1,2,5,5,0,5,0,3 (3ct 0st),2.5,
0,IAR Peebles (ENG),1927-1931,13,21,5,5,0,0,5,1 (1ct 0st),0.23800000000000002,
1,SJ Pegler (SA),1910-1924,16,24,5,5,0,0,5,2 (2ct 0st),0.20800000000000002,
2,N Phillip (WI),1978-1979,9,15,5,5,0,0,5,2 (2ct 0st),0.33299999999999996,
3,PI Philpott (AUS),1965-1966,8,15,5,5,0,0,5,2 (2ct 0st),0.33299999999999996,
4,DL Piedt (SA),2014-2019,9,16,5,5,0,0,5,2 (2ct 0st),0.312,
5,BA Pocock (NZ),1993-1997,15,24,5,5,0,0,5,1 (1ct 0st),0.20800000000000002,
6,OJ Pope (ENG),2018-2019,4,7,5,5,0,1,4,2 (2ct 0st),0.7140000000000001,
7,PH Punjabi (INDIA),1955-1955,5,9,5,5,0,0,5,1 (1ct 0st),0.555,
8,RJ Quiney (AUS),2012-2012,2,4,5,5,0,0,5,2 (2ct 0st),1.25,
9,GO Rabone (NZ),1949-1955,12,19,5,5,0,0,5,2 (2ct 0st),0.263,
10,AJ Redmond (NZ),2008-2013,8,12,5,5,0,0,5,2 (2ct 0st),0.41600000000000004,
11,BA Reid (AUS),1985-1992,27,46,5,5,0,0,5,1 (1ct 0st),0.10800000000000001,
12,T Richardson (ENG),1893-1898,14,25,5,5,0,0,5,1 (1ct 0st),0.2,
13,KE Rigg (AUS),1931-1937,8,16,5,5,0,0,5,1 (1ct 0st),0.312,
14,DT Ring (AUS),1948-1953,13,26,5,5,0,0,5,1 (1ct 0st),0.192,
15,CA Roach (WI),1928-1935,16,23,5,5,0,0,5,1 (1ct 0st),0.217,
16,Robiul Islam (BDESH),2010-2014,9,17,5,5,0,0,5,1 (1ct 0st),0.294,
17,SD Robson (ENG),2014-2014,7,14,5,5,0,0,5,1 (1ct 0st),0.35700000000000004,
18,L Ronchi (NZ),2015-2016,4,8,5,5,0,5,0,2 (2ct 0st),0.625,
19,IDK Salisbury (ENG),1992-2000,15,27,5,5,0,0,5,2 (2ct 0st),0.185,
20,DP Samaraweera (SL),1993-1995,7,9,5,5,0,0,5,2 (2ct 0st),0.555,
21,JV Saunders (AUS),1902-1908,14,27,5,5,0,0,5,2 (2ct 0st),0.185,
22,Shafqat Rana (PAK),1964-1969,5,9,5,5,0,0,5,2 (2ct 0st),0.555,
23,Shahid Nazir (PAK),1996-2007,15,29,5,5,0,0,5,2 (2ct 0st),0.172,
24,RJ Sidebottom (ENG),2001-2010,22,37,5,5,0,0,5,1 (1ct 0st),0.135,
25,LMP Simmons (WI),2009-2011,8,15,5,5,0,0,5,1 (1ct 0st),0.33299999999999996,
26,RT Simpson (ENG),1948-1955,27,51,5,5,0,0,5,2 (2ct 0st),0.098,
27,RR Singh (INDIA),1998-1998,1,2,5,5,0,0,5,3 (3ct 0st),2.5,
28,CL Smith (ENG),1983-1986,8,16,5,5,0,0,5,2 (2ct 0st),0.312,
29,CW Smith (WI),1960-1962,5,10,5,4,1,1,3,3 (3ct 0st),0.5,
30,ET Smith (ENG),2003-2003,3,6,5,5,0,0,5,2 (2ct 0st),0.833,
31,Sohag Gazi (BDESH),2012-2014,10,18,5,5,0,0,5,1 (1ct 0st),0.27699999999999997,
32,S Sreesanth (INDIA),2006-2011,27,50,5,5,0,0,5,2 (2ct 0st),0.1,
33,AG Steel (ENG),1880-1888,13,24,5,5,0,0,5,1 (1ct 0st),0.20800000000000002,
34,CT Studd (ENG),1882-1883,5,10,5,5,0,0,5,2 (2ct 0st),0.5,
35,R Subba Row (ENG),1958-1961,13,23,5,5,0,0,5,1 (1ct 0st),0.217,
36,PL Symcox (SA),1993-1998,20,35,5,5,0,0,5,2 (2ct 0st),0.142,
37,GJ Thompson (ENG),1909-1910,6,12,5,5,0,0,5,2 (2ct 0st),0.41600000000000004,
38,RW Tolchard (ENG),1977-1977,4,8,5,5,0,0,5,1 (1ct 0st),0.625,
39,RG Twose (NZ),1995-1999,16,28,5,5,0,0,5,1 (1ct 0st),0.17800000000000002,
40,KG Viljoen (SA),1930-1949,27,46,5,5,0,0,5,1 (1ct 0st),0.10800000000000001,
41,Wahab Riaz (PAK),2010-2018,27,52,5,5,0,0,5,1 (1ct 0st),0.096,
42,PM Walker (ENG),1960-1960,3,6,5,5,0,0,5,2 (2ct 0st),0.833,
43,WM Wallace (NZ),1937-1953,13,20,5,5,0,0,5,1 (1ct 0st),0.25,
44,Wazir Mohammad (PAK),1952-1959,20,37,5,5,0,0,5,1 (1ct 0st),0.135,
45,UWMBCA Welegedara (SL),2007-2014,21,36,5,5,0,0,5,1 (1ct 0st),0.138,
46,DM Wellham (AUS),1981-1987,6,10,5,5,0,0,5,2 (2ct 0st),0.5,
47,AB Williams (WI),1978-1979,7,12,5,5,0,0,5,2 (2ct 0st),0.41600000000000004,
48,MA Wood (ENG),2015-2019,13,25,5,5,0,0,5,1 (1ct 0st),0.2,
49,SMJ Woods (AUS/ENG),1888-1896,6,10,5,5,0,0,5,3 (3ct 0st),0.5,
0,JA Young (ENG),1947-1949,8,14,5,5,0,0,5,1 (1ct 0st),0.35700000000000004,
1,Zahid Fazal (PAK),1990-1995,9,16,5,5,0,0,5,1 (1ct 0st),0.312,
2,Zulfiqar Ahmed (PAK),1952-1956,9,16,5,5,0,0,5,1 (1ct 0st),0.312,
3,KJ Abbott (SA),2013-2017,11,21,4,4,0,0,4,1 (1ct 0st),0.19,
4,Abdur Razzak (BDESH),2006-2018,13,21,4,4,0,0,4,1 (1ct 0st),0.19,
5,EL a'Beckett (AUS),1928-1932,4,8,4,4,0,0,4,2 (2ct 0st),0.5,
6,NAT Adcock (SA),1953-1962,26,48,4,4,0,0,4,1 (1ct 0st),0.083,
7,PJW Allott (ENG),1981-1985,13,24,4,4,0,0,4,1 (1ct 0st),0.166,
8,S Amarnath (INDIA),1976-1978,10,17,4,4,0,0,4,2 (2ct 0st),0.235,
9,SD Anurasiri (SL),1986-1998,18,27,4,4,0,0,4,1 (1ct 0st),0.14800000000000002,
10,R Appleyard (ENG),1954-1956,9,18,4,4,0,0,4,2 (2ct 0st),0.222,
11,KJ Arnott (ZIM),1992-1993,4,6,4,4,0,0,4,2 (2ct 0st),0.6659999999999999,
12,HMCM Bandara (SL),1998-2006,8,15,4,4,0,0,4,1 (1ct 0st),0.266,
13,SB Bangar (INDIA),2001-2002,12,22,4,4,0,0,4,1 (1ct 0st),0.18100000000000002,
14,PT Barton (NZ),1961-1963,7,11,4,4,0,0,4,2 (2ct 0st),0.363,
15,G Bean (ENG),1892-1892,3,6,4,4,0,0,4,2 (2ct 0st),0.6659999999999999,
16,STR Binny (INDIA),2014-2015,6,9,4,4,0,0,4,1 (1ct 0st),0.444,
17,LS Birkett (WI),1930-1931,4,5,4,4,0,0,4,2 (2ct 0st),0.8,
18,EA Brandes (ZIM),1992-1999,10,18,4,4,0,0,4,1 (1ct 0st),0.222,
19,IG Butler (NZ),2002-2004,8,14,4,4,0,0,4,1 (1ct 0st),0.285,
20,MR Bynoe (WI),1959-1967,4,8,4,4,0,0,4,1 (1ct 0st),0.5,
21,GS Camacho (WI),1968-1971,11,18,4,4,0,0,4,1 (1ct 0st),0.222,
22,JD Campbell (WI),2019-2019,6,12,4,4,0,0,4,1 (1ct 0st),0.33299999999999996,
23,PVD Chameera (SL),2015-2019,8,14,4,4,0,0,4,1 (1ct 0st),0.285,
24,S Chattergoon (WI),2008-2008,4,8,4,4,0,0,4,1 (1ct 0st),0.5,
25,SR Clark (AUS),2006-2009,24,48,4,4,0,0,4,1 (1ct 0st),0.083,
26,IA Colquhoun (NZ),1955-1955,2,3,4,4,0,4,0,2 (2ct 0st),1.3330000000000002,
27,WW Daniel (WI),1976-1984,10,20,4,4,0,0,4,1 (1ct 0st),0.2,
28,CA Davis (WI),1968-1973,15,27,4,4,0,0,4,1 (1ct 0st),0.14800000000000002,
29,HT Davis (NZ),1994-1997,5,9,4,4,0,0,4,1 (1ct 0st),0.444,
30,EAR de Silva (SL),1985-1991,10,16,4,4,0,0,4,1 (1ct 0st),0.25,
31,AJ Doolan (AUS),2014-2014,4,8,4,4,0,0,4,2 (2ct 0st),0.5,
32,CJ Drum (NZ),2001-2002,5,9,4,4,0,0,4,1 (1ct 0st),0.444,
33,MA Ealham (ENG),1996-1998,8,13,4,4,0,0,4,1 (1ct 0st),0.307,
34,MK Elgie (SA),1961-1962,3,6,4,4,0,0,4,2 (2ct 0st),0.6659999999999999,
35,NH Fairbrother (ENG),1987-1993,10,15,4,4,0,0,4,2 (2ct 0st),0.266,
36,TCB Fernando (SL),2001-2002,9,17,4,4,0,0,4,2 (2ct 0st),0.235,
37,JJ Ferris (AUS/ENG),1887-1892,9,16,4,4,0,0,4,1 (1ct 0st),0.25,
38,A Fielder (ENG),1904-1908,6,12,4,4,0,0,4,2 (2ct 0st),0.33299999999999996,
39,AP Freeman (ENG),1924-1929,12,23,4,4,0,0,4,1 (1ct 0st),0.17300000000000001,
40,AB Fudadin (WI),2012-2012,3,5,4,4,0,0,4,2 (2ct 0st),0.8,
41,LH Gay (ENG),1894-1894,1,2,4,3,1,3,0,3 (2ct 1st),2.0,
42,JM Ghorpade (INDIA),1953-1959,8,12,4,4,0,0,4,1 (1ct 0st),0.33299999999999996,
43,PA Gibb (ENG),1938-1946,8,14,4,3,1,3,0,2 (1ct 1st),0.285,
44,R Gilchrist (WI),1957-1959,13,23,4,4,0,0,4,1 (1ct 0st),0.17300000000000001,
45,HC Griffith (WI),1928-1933,13,18,4,4,0,0,4,1 (1ct 0st),0.222,
46,NE Haig (ENG),1921-1930,5,10,4,4,0,0,4,2 (2ct 0st),0.4,
47,AE Hall (SA),1923-1931,7,14,4,4,0,0,4,1 (1ct 0st),0.285,
48,H Hameed (ENG),2016-2016,3,6,4,4,0,0,4,3 (3ct 0st),0.6659999999999999,
49,Hasan Ali (PAK),2017-2019,9,17,4,4,0,0,4,1 (1ct 0st),0.235,
0,M Hayward (SA),1999-2004,16,31,4,4,0,0,4,1 (1ct 0st),0.129,
1,GR Hazlitt (AUS),1907-1912,9,15,4,4,0,0,4,1 (1ct 0st),0.266,
2,JT Hearne (ENG),1892-1899,12,22,4,4,0,0,4,2 (2ct 0st),0.18100000000000002,
3,K Higgs (ENG),1965-1968,15,27,4,4,0,0,4,1 (1ct 0st),0.14800000000000002,
4,JW Hitch (ENG),1911-1921,7,12,4,4,0,0,4,1 (1ct 0st),0.33299999999999996,
5,AJ Hollioake (ENG),1997-1998,4,6,4,4,0,0,4,1 (1ct 0st),0.6659999999999999,
6,ERT Holmes (ENG),1935-1935,5,9,4,4,0,0,4,2 (2ct 0st),0.444,
7,ND Howard (ENG),1951-1952,4,7,4,4,0,0,4,2 (2ct 0st),0.5710000000000001,
8,Ibrahim Zadran (AFG),2019-2019,2,4,4,4,0,0,4,2 (2ct 0st),1.0,
9,Ihsanullah (AFG),2019-2019,3,6,4,4,0,0,4,2 (2ct 0st),0.6659999999999999,
10,Imran Nazir (PAK),1999-2002,8,14,4,4,0,0,4,1 (1ct 0st),0.285,
11,RJ Inverarity (AUS),1968-1972,6,12,4,4,0,0,4,2 (2ct 0st),0.33299999999999996,
12,M Jahangir Khan (INDIA),1932-1936,4,7,4,4,0,0,4,3 (3ct 0st),0.5710000000000001,
13,RO Jenkins (ENG),1948-1952,9,18,4,4,0,0,4,1 (1ct 0st),0.222,
14,IJ Jones (ENG),1964-1968,15,27,4,4,0,0,4,1 (1ct 0st),0.14800000000000002,
15,PEW Jones (WI),1948-1951,9,18,4,4,0,0,4,1 (1ct 0st),0.222,
16,SP Jones (ENG),2002-2005,18,35,4,4,0,0,4,1 (1ct 0st),0.114,
17,BP Julian (AUS),1993-1995,7,14,4,4,0,0,4,1 (1ct 0st),0.285,
18,RR Jumadeen (WI),1972-1979,12,22,4,4,0,0,4,2 (2ct 0st),0.18100000000000002,
19,Junaid Khan (PAK),2011-2015,22,43,4,4,0,0,4,2 (2ct 0st),0.09300000000000001,
20,JL Kerr (NZ),1931-1937,7,10,4,4,0,0,4,2 (2ct 0st),0.4,
21,Khan Mohammad (PAK),1952-1958,13,22,4,4,0,0,4,2 (2ct 0st),0.18100000000000002,
22,H Klaasen (SA),2019-2019,1,1,4,3,1,3,0,4 (3ct 1st),4.0,
23,JJ Krejza (AUS),2008-2008,2,4,4,4,0,0,4,3 (3ct 0st),1.0,
24,AG Kripal Singh (INDIA),1955-1964,14,25,4,4,0,0,4,1 (1ct 0st),0.16,
25,CBRLS Kumara (SL),2016-2019,19,32,4,4,0,0,4,1 (1ct 0st),0.125,
26,PD Lashley (WI),1960-1966,4,8,4,4,0,0,4,2 (2ct 0st),0.5,
27,WH Lockwood (ENG),1893-1902,12,20,4,4,0,0,4,2 (2ct 0st),0.2,
28,JE McConnon (ENG),1954-1954,2,4,4,4,0,0,4,4 (4ct 0st),1.0,
29,TR McKibbin (AUS),1895-1898,5,10,4,4,0,0,4,2 (2ct 0st),0.4,
30,DL Maddy (ENG),1999-2000,3,5,4,4,0,0,4,1 (1ct 0st),0.8,
31,Manjural Islam (BDESH),2001-2004,17,22,4,4,0,0,4,1 (1ct 0st),0.18100000000000002,
32,FT Mann (ENG),1922-1923,5,9,4,4,0,0,4,1 (1ct 0st),0.444,
33,CR Matthews (SA),1992-1995,18,33,4,4,0,0,4,2 (2ct 0st),0.121,
34,CP Mead (ENG),1911-1928,17,31,4,4,0,0,4,1 (1ct 0st),0.129,
35,MG Melle (SA),1950-1953,7,12,4,4,0,0,4,2 (2ct 0st),0.33299999999999996,
36,KD Mills (NZ),2004-2009,19,33,4,4,0,0,4,1 (1ct 0st),0.121,
37,Mohammad Akram (PAK),1995-2001,9,15,4,4,0,0,4,1 (1ct 0st),0.266,
38,Mohammad Nazir (PAK),1969-1983,14,23,4,4,0,0,4,1 (1ct 0st),0.17300000000000001,
39,Mohammad Salim (BDESH),2003-2003,2,2,4,3,1,3,0,2 (2ct 0st),2.0,
40,Mohsin Kamal (PAK),1984-1994,9,15,4,4,0,0,4,1 (1ct 0st),0.266,
41,LJ Moon (ENG),1906-1906,4,7,4,4,0,1,3,2 (2ct 0st),0.5710000000000001,
42,F Morley (ENG),1880-1883,4,8,4,4,0,0,4,2 (2ct 0st),0.5,
43,CB Mpofu (ZIM),2005-2017,15,24,4,4,0,0,4,1 (1ct 0st),0.166,
44,Naimur Rahman (BDESH),2000-2002,8,11,4,4,0,0,4,2 (2ct 0st),0.363,
45,CK Nayudu (INDIA),1932-1936,7,13,4,4,0,0,4,1 (1ct 0st),0.307,
46,ML Nkala (ZIM),2000-2005,10,17,4,4,0,0,4,2 (2ct 0st),0.235,
47,TC O'Brien (ENG),1884-1896,5,9,4,4,0,0,4,1 (1ct 0st),0.444,
48,SP O'Donnell (AUS),1985-1985,6,10,4,4,0,0,4,2 (2ct 0st),0.4,
49,S O'Linn (SA),1960-1961,7,13,4,4,0,0,4,2 (2ct 0st),0.307,
0,HGO Owen-Smith (SA),1929-1929,5,9,4,4,0,0,4,2 (2ct 0st),0.444,
1,RK Oxenham (AUS),1928-1931,7,14,4,4,0,0,4,1 (1ct 0st),0.285,
2,DR Parry (WI),1978-1980,12,21,4,4,0,0,4,1 (1ct 0st),0.19,
3,CT Patankar (INDIA),1955-1956,1,2,4,3,1,3,0,4 (3ct 1st),2.0,
4,CE Pellew (AUS),1920-1921,10,20,4,4,0,0,4,1 (1ct 0st),0.2,
5,PJ Petherick (NZ),1976-1977,6,12,4,4,0,0,4,2 (2ct 0st),0.33299999999999996,
6,WR Playle (NZ),1958-1963,8,10,4,4,0,0,4,1 (1ct 0st),0.4,
7,RW Price (ZIM),1999-2013,22,37,4,4,0,0,4,2 (2ct 0st),0.10800000000000001,
8,MJ Procter (SA),1967-1970,7,14,4,4,0,0,4,2 (2ct 0st),0.285,
9,WG Quaife (ENG),1899-1902,7,14,4,4,0,0,4,2 (2ct 0st),0.285,
10,CT Radley (ENG),1978-1978,8,15,4,4,0,0,4,1 (1ct 0st),0.266,
11,V Rajindernath (INDIA),1952-1952,1,2,4,0,4,0,0,2 (0ct 2st),2.0,
12,CAK Rajitha (SL),2018-2019,7,12,4,4,0,0,4,3 (3ct 0st),0.33299999999999996,
13,AU Rashid (ENG),2015-2019,19,36,4,4,0,0,4,1 (1ct 0st),0.111,
14,DM Richards (WI),2009-2010,3,6,4,4,0,0,4,1 (1ct 0st),0.6659999999999999,
15,Rizwan-uz-Zaman (PAK),1981-1989,11,19,4,4,0,0,4,1 (1ct 0st),0.21,
16,ADG Roberts (NZ),1976-1976,7,14,4,4,0,0,4,1 (1ct 0st),0.285,
17,AW Roberts (NZ),1930-1937,5,9,4,4,0,0,4,1 (1ct 0st),0.444,
18,RD Robinson (AUS),1977-1977,3,5,4,4,0,0,4,1 (1ct 0st),0.8,
19,BC Rose (ENG),1977-1981,9,13,4,4,0,0,4,2 (2ct 0st),0.307,
20,FA Rose (WI),1997-2000,19,33,4,4,0,0,4,2 (2ct 0st),0.121,
21,GA Rowe (SA),1896-1902,5,8,4,4,0,0,4,2 (2ct 0st),0.5,
22,WE Russell (ENG),1961-1967,10,18,4,4,0,0,4,2 (2ct 0st),0.222,
23,S Samarawickrama (SL),2017-2017,4,7,4,4,0,0,4,2 (2ct 0st),0.5710000000000001,
24,A Sandham (ENG),1921-1930,14,24,4,4,0,0,4,1 (1ct 0st),0.166,
25,A Sanford (WI),2002-2004,11,19,4,4,0,0,4,2 (2ct 0st),0.21,
26,DN Sardesai (INDIA),1961-1972,30,55,4,4,0,0,4,1 (1ct 0st),0.07200000000000001,
27,WH Scotton (ENG),1881-1887,15,28,4,4,0,0,4,2 (2ct 0st),0.142,
28,Shakeel Ahmed jnr (PAK),1993-1995,3,6,4,4,0,0,4,2 (2ct 0st),0.6659999999999999,
29,A Shaw (ENG),1877-1882,7,13,4,4,0,0,4,2 (2ct 0st),0.307,
30,JN Shepherd (WI),1969-1971,5,10,4,4,0,0,4,2 (2ct 0st),0.4,
31,MW Sievers (AUS),1936-1937,3,5,4,4,0,0,4,2 (2ct 0st),0.8,
32,PR Sleep (AUS),1979-1990,14,23,4,4,0,0,4,1 (1ct 0st),0.17300000000000001,
33,RH Spooner (ENG),1905-1912,10,18,4,4,0,0,4,1 (1ct 0st),0.222,
34,PR Stirling (IRE),2018-2019,3,6,4,4,0,0,4,2 (2ct 0st),0.6659999999999999,
35,PM Such (ENG),1993-1999,11,20,4,4,0,0,4,2 (2ct 0st),0.2,
36,Surendranath (INDIA),1958-1961,11,17,4,4,0,0,4,2 (2ct 0st),0.235,
37,Talat Ali (PAK),1972-1979,10,16,4,4,0,0,4,1 (1ct 0st),0.25,
38,DJ Terbrugge (SA),1998-2004,7,14,4,4,0,0,4,1 (1ct 0st),0.285,
39,ERH Toshack (AUS),1946-1948,12,24,4,4,0,0,4,1 (1ct 0st),0.166,
40,CT Tremlett (ENG),2007-2013,12,24,4,4,0,0,4,1 (1ct 0st),0.166,
41,AE Trott (AUS/ENG),1895-1899,5,10,4,4,0,0,4,3 (3ct 0st),0.4,
42,FH Tyson (ENG),1954-1959,17,32,4,4,0,0,4,1 (1ct 0st),0.125,
43,JTC Vaughan (NZ),1992-1997,6,9,4,4,0,0,4,2 (2ct 0st),0.444,
44,HG Vivian (NZ),1931-1937,7,11,4,4,0,0,4,1 (1ct 0st),0.363,
45,HF Wade (SA),1935-1936,10,15,4,4,0,0,4,1 (1ct 0st),0.266,
46,W Watson (NZ),1986-1993,15,26,4,4,0,0,4,1 (1ct 0st),0.153,
47,WJ Whitty (AUS),1909-1912,14,25,4,4,0,0,4,1 (1ct 0st),0.16,
48,JM Wiener (AUS),1979-1980,6,10,4,4,0,0,4,2 (2ct 0st),0.4,
49,BA Williams (AUS),2003-2004,4,8,4,4,0,0,4,2 (2ct 0st),0.5,
0,DNT Zoysa (SL),1997-2004,30,51,4,4,0,0,4,1 (1ct 0st),0.078,
1,Zubayr Hamza (SA),2019-2019,3,5,4,4,0,0,4,2 (2ct 0st),0.8,
2,JW Zulch (SA),1910-1921,16,30,4,4,0,0,4,1 (1ct 0st),0.133,
3,Zulfiqar Babar (PAK),2013-2016,15,28,4,4,0,0,4,1 (1ct 0st),0.142,
4,Abul Hasan (BDESH),2012-2013,3,6,3,3,0,0,3,2 (2ct 0st),0.5,
5,Aftab Gul (PAK),1969-1971,6,11,3,3,0,0,3,1 (1ct 0st),0.272,
6,Agha Saadat Ali (PAK),1955-1955,1,2,3,3,0,0,3,2 (2ct 0st),1.5,
7,Ahmed Shehzad (PAK),2013-2017,13,26,3,3,0,0,3,1 (1ct 0st),0.115,
8,Akram Khan (BDESH),2000-2003,8,11,3,3,0,0,3,1 (1ct 0st),0.272,
9,CFW Allcott (NZ),1930-1932,6,9,3,3,0,0,3,1 (1ct 0st),0.33299999999999996,
10,L Amar Singh (INDIA),1932-1936,7,13,3,3,0,0,3,1 (1ct 0st),0.23,
11,AMJG Amerasinghe (SL),1984-1984,2,3,3,3,0,0,3,2 (2ct 0st),1.0,
12,BJ Arnel (NZ),2010-2012,6,12,3,3,0,0,3,1 (1ct 0st),0.25,
13,RA Austin (WI),2009-2009,2,4,3,3,0,0,3,2 (2ct 0st),0.75,
14,KBJ Azad (INDIA),1981-1983,7,14,3,3,0,0,3,1 (1ct 0st),0.214,
15,CL Badcock (AUS),1936-1938,7,11,3,3,0,0,3,1 (1ct 0st),0.272,
16,AH Bakewell (ENG),1931-1935,6,12,3,3,0,0,3,2 (2ct 0st),0.25,
17,A Balbirnie (IRE),2018-2019,3,6,3,3,0,0,3,1 (1ct 0st),0.5,
18,SA Banerjee (INDIA),1948-1949,1,2,3,3,0,0,3,2 (2ct 0st),1.5,
19,GJ Batty (ENG),2003-2016,9,16,3,3,0,0,3,2 (2ct 0st),0.187,
20,GP Bilby (NZ),1966-1966,2,3,3,3,0,0,3,1 (1ct 0st),1.0,
21,J Birkenshaw (ENG),1973-1974,5,9,3,3,0,0,3,2 (2ct 0st),0.33299999999999996,
22,M Bisset (SA),1899-1910,3,6,3,2,1,2,0,1 (1ct 0st),0.5,
23,TA Blundell (NZ),2017-2019,3,6,3,3,0,2,1,1 (1ct 0st),0.5,
24,J Botha (SA),2006-2010,5,10,3,3,0,0,3,1 (1ct 0st),0.3,
25,IDR Bradshaw (WI),2006-2006,5,7,3,3,0,0,3,2 (2ct 0st),0.428,
26,VR Brown (NZ),1985-1985,2,4,3,3,0,0,3,2 (2ct 0st),0.75,
27,JJ Bumrah (INDIA),2018-2019,12,24,3,3,0,0,3,1 (1ct 0st),0.125,
28,RO Butcher (ENG),1981-1981,3,4,3,3,0,0,3,2 (2ct 0st),0.75,
29,Hon.FSG Calthorpe (ENG),1930-1930,4,8,3,3,0,0,3,1 (1ct 0st),0.375,
30,PR Carlstein (SA),1958-1964,8,15,3,3,0,0,3,1 (1ct 0st),0.2,
31,AW Carr (ENG),1922-1929,11,16,3,3,0,0,3,1 (1ct 0st),0.187,
32,JAJ Christy (SA),1929-1932,10,17,3,3,0,0,3,1 (1ct 0st),0.17600000000000002,
33,CK Coventry (ZIM),2005-2005,2,3,3,3,0,0,3,2 (2ct 0st),1.0,
34,J Cowie (NZ),1937-1949,9,14,3,3,0,0,3,2 (2ct 0st),0.214,
35,K Cranston (ENG),1947-1948,8,16,3,3,0,0,3,2 (2ct 0st),0.187,
36,RJ Crisp (SA),1935-1936,9,14,3,3,0,0,3,1 (1ct 0st),0.214,
37,CD Cumming (NZ),2005-2008,11,20,3,3,0,0,3,1 (1ct 0st),0.15,
38,TS Curtis (ENG),1988-1989,5,9,3,3,0,0,3,1 (1ct 0st),0.33299999999999996,
39,RKJ Dawson (ENG),2001-2003,7,11,3,3,0,0,3,2 (2ct 0st),0.272,
40,JH de Courcy (AUS),1953-1953,3,5,3,3,0,0,3,2 (2ct 0st),0.6,
41,GR Dickinson (NZ),1930-1932,3,6,3,3,0,0,3,2 (2ct 0st),0.5,
42,GHG Doggart (ENG),1950-1950,2,4,3,3,0,0,3,1 (1ct 0st),0.75,
43,B Dooland (AUS),1947-1948,3,6,3,3,0,0,3,1 (1ct 0st),0.5,
44,UG Dowe (WI),1971-1973,4,8,3,3,0,0,3,1 (1ct 0st),0.375,
45,A D'Souza (PAK),1959-1962,6,10,3,3,0,0,3,2 (2ct 0st),0.3,
46,CAR Duckworth (SA),1957-1957,2,4,3,3,0,0,3,1 (1ct 0st),0.75,
47,R Dumbrill (SA),1965-1967,5,10,3,3,0,0,3,1 (1ct 0st),0.3,
48,Enamul Haque jnr (BDESH),2003-2013,15,27,3,3,0,0,3,1 (1ct 0st),0.111,
49,Fakhar Zaman (PAK),2018-2019,3,6,3,3,0,0,3,1 (1ct 0st),0.5,
0,Fawad Alam (PAK),2009-2009,3,6,3,3,0,0,3,1 (1ct 0st),0.5,
1,BOP Fernando (SL),2019-2019,4,7,3,3,0,0,3,1 (1ct 0st),0.428,
2,MLC Foster (WI),1969-1978,14,26,3,3,0,0,3,1 (1ct 0st),0.115,
3,ERH Fuller (SA),1953-1958,7,12,3,3,0,0,3,1 (1ct 0st),0.25,
4,DJ Gandhi (INDIA),1999-1999,4,8,3,3,0,0,3,1 (1ct 0st),0.375,
5,JB Gannon (AUS),1977-1978,3,5,3,3,0,0,3,2 (2ct 0st),0.6,
6,AER Gilligan (ENG),1922-1925,11,21,3,3,0,0,3,1 (1ct 0st),0.142,
7,TWJ Goddard (ENG),1930-1939,8,13,3,3,0,0,3,1 (1ct 0st),0.23,
8,MJ Gopalan (INDIA),1934-1934,1,2,3,3,0,0,3,2 (2ct 0st),1.5,
9,H Graham (AUS),1893-1896,6,11,3,3,0,0,3,1 (1ct 0st),0.272,
10,GA Greenidge (WI),1972-1973,5,9,3,3,0,0,3,1 (1ct 0st),0.33299999999999996,
11,Gul Mohammad (INDIA/PAK),1946-1956,9,13,3,3,0,0,3,1 (1ct 0st),0.23,
12,JR Gunn (ENG),1901-1905,6,12,3,3,0,0,3,1 (1ct 0st),0.25,
13,PAM Hands (SA),1913-1924,7,10,3,3,0,0,3,2 (2ct 0st),0.3,
14,MS Hardikar (INDIA),1958-1958,2,4,3,3,0,0,3,2 (2ct 0st),0.75,
15,NM Hauritz (AUS),2004-2010,17,33,3,3,0,0,3,1 (1ct 0st),0.09,
16,Lord Hawke (ENG),1896-1899,5,10,3,3,0,0,3,2 (2ct 0st),0.3,
17,JA Hayes (NZ),1951-1958,15,20,3,3,0,0,3,2 (2ct 0st),0.15,
18,F Hearne (ENG/SA),1889-1896,6,9,3,3,0,0,3,1 (1ct 0st),0.33299999999999996,
19,GAL Hearne (SA),1922-1924,3,5,3,3,0,0,3,3 (3ct 0st),0.6,
20,C Heseltine (ENG),1896-1896,2,4,3,3,0,0,3,1 (1ct 0st),0.75,
21,JD Higgs (AUS),1978-1981,22,39,3,3,0,0,3,1 (1ct 0st),0.076,
22,DD Hindlekar (INDIA),1936-1946,4,7,3,3,0,3,0,1 (1ct 0st),0.428,
23,TV Hohns (AUS),1989-1989,7,13,3,3,0,0,3,1 (1ct 0st),0.23,
24,P Holmes (ENG),1921-1932,7,14,3,3,0,0,3,2 (2ct 0st),0.214,
25,KA Hope (WI),2017-2017,5,9,3,3,0,0,3,1 (1ct 0st),0.33299999999999996,
26,PA Horne (NZ),1987-1990,4,7,3,3,0,0,3,1 (1ct 0st),0.428,
27,AG Huckle (ZIM),1997-1998,8,14,3,3,0,0,3,1 (1ct 0st),0.214,
28,AG Hurst (AUS),1974-1979,12,22,3,3,0,0,3,1 (1ct 0st),0.136,
29,P Hutchinson (SA),1889-1889,2,3,3,3,0,0,3,2 (2ct 0st),1.0,
30,Ijaz Ahmed jnr (PAK),1995-1995,2,4,3,3,0,0,3,2 (2ct 0st),0.75,
31,JK Irani (INDIA),1947-1947,2,2,3,2,1,2,0,2 (1ct 1st),1.5,
32,H Ironmonger (AUS),1928-1933,14,28,3,3,0,0,3,2 (2ct 0st),0.107,
33,KM Jarvis (ZIM),2011-2018,12,21,3,3,0,0,3,1 (1ct 0st),0.142,
34,TW Jarvis (NZ),1965-1973,13,24,3,3,0,0,3,2 (2ct 0st),0.125,
35,CEL Jones (WI),1930-1935,4,8,3,3,0,0,3,2 (2ct 0st),0.375,
36,SC Joseph (WI),2004-2007,5,9,3,3,0,0,3,1 (1ct 0st),0.33299999999999996,
37,PHT Kaushal (SL),2014-2015,7,14,3,3,0,0,3,2 (2ct 0st),0.214,
38,JM Kemp (SA),2001-2005,4,8,3,3,0,0,3,1 (1ct 0st),0.375,
39,Khalid Ibadulla (PAK),1964-1967,4,8,3,3,0,0,3,2 (2ct 0st),0.375,
40,RJ Kirtley (ENG),2003-2003,4,7,3,3,0,0,3,1 (1ct 0st),0.428,
41,JJ Kotze (SA),1902-1907,3,5,3,3,0,0,3,1 (1ct 0st),0.6,
42,Kuldeep Yadav (INDIA),2017-2019,6,11,3,3,0,0,3,1 (1ct 0st),0.272,
43,GF Labrooy (SL),1986-1991,9,15,3,3,0,0,3,1 (1ct 0st),0.2,
44,TJ Laughlin (AUS),1978-1978,3,6,3,3,0,0,3,2 (2ct 0st),0.5,
45,JJC Lawson (WI),2002-2005,13,26,3,3,0,0,3,1 (1ct 0st),0.115,
46,E Leadbeater (ENG),1951-1952,2,4,3,3,0,0,3,2 (2ct 0st),0.75,
47,WHV Levett (ENG),1934-1934,1,2,3,3,0,3,0,3 (3ct 0st),1.5,
48,HSB Love (AUS),1933-1933,1,2,3,3,0,3,0,3 (3ct 0st),1.5,
49,JJ Lyons (AUS),1887-1897,14,25,3,3,0,0,3,1 (1ct 0st),0.12,
0,EA McDonald (AUS),1921-1921,11,22,3,3,0,0,3,1 (1ct 0st),0.136,
1,A McGrath (ENG),2003-2003,4,7,3,3,0,0,3,1 (1ct 0st),0.428,
2,RW McLeod (AUS),1892-1893,6,10,3,3,0,0,3,1 (1ct 0st),0.3,
3,ES Maka (INDIA),1952-1953,2,3,3,2,1,2,0,3 (2ct 1st),1.0,
4,FG Mann (ENG),1948-1949,7,13,3,3,0,0,3,2 (2ct 0st),0.23,
5,NBF Mann (SA),1947-1951,19,34,3,3,0,0,3,1 (1ct 0st),0.08800000000000001,
6,GA Manou (AUS),2009-2009,1,1,3,3,0,3,0,3 (3ct 0st),3.0,
7,Manjural Islam Rana (BDESH),2004-2004,6,7,3,3,0,0,3,2 (2ct 0st),0.428,
8,JR Mason (ENG),1897-1898,5,8,3,3,0,0,3,1 (1ct 0st),0.375,
9,EH Mattis (WI),1981-1981,4,8,3,3,0,0,3,2 (2ct 0st),0.375,
10,B Mavuta (ZIM),2018-2018,2,4,3,3,0,0,3,2 (2ct 0st),0.75,
11,MP Maynard (ENG),1988-1994,4,8,3,3,0,0,3,1 (1ct 0st),0.375,
12,LC Mayne (AUS),1965-1970,6,12,3,3,0,0,3,1 (1ct 0st),0.25,
13,DJ Meintjes (SA),1923-1923,2,4,3,3,0,0,3,2 (2ct 0st),0.75,
14,RS Modi (INDIA),1946-1952,10,16,3,3,0,0,3,1 (1ct 0st),0.187,
15,Mohammad Asif (PAK),2005-2010,23,45,3,3,0,0,3,1 (1ct 0st),0.066,
16,Mohammad Salman (PAK),2011-2011,2,4,3,2,1,2,0,1 (1ct 0st),0.75,
17,DAR Moloney (NZ),1937-1937,3,6,3,3,0,0,3,2 (2ct 0st),0.5,
18,H Morris (ENG),1991-1991,3,6,3,3,0,0,3,1 (1ct 0st),0.5,
19,JE Morris (ENG),1990-1990,3,5,3,3,0,0,3,2 (2ct 0st),0.6,
20,JB Mortimore (ENG),1959-1964,9,17,3,3,0,0,3,1 (1ct 0st),0.17600000000000002,
21,ARA Murray (SA),1952-1954,10,18,3,3,0,0,3,1 (1ct 0st),0.166,
22,Naved-ul-Hasan (PAK),2004-2007,9,17,3,3,0,0,3,2 (2ct 0st),0.17600000000000002,
23,CS Nayudu (INDIA),1934-1952,11,17,3,3,0,0,3,1 (1ct 0st),0.17600000000000002,
24,C Newberry (SA),1913-1914,4,7,3,3,0,0,3,3 (3ct 0st),0.428,
25,ES Newson (SA),1930-1939,3,6,3,3,0,0,3,2 (2ct 0st),0.5,
26,L Ngidi (SA),2018-2019,5,9,3,3,0,0,3,1 (1ct 0st),0.33299999999999996,
27,F Nicholson (SA),1935-1936,4,6,3,3,0,3,0,2 (2ct 0st),0.5,
28,HC Nitschke (AUS),1931-1931,2,4,3,3,0,0,3,1 (1ct 0st),0.75,
29,LPJ O'Brien (AUS),1932-1936,5,9,3,3,0,0,3,2 (2ct 0st),0.33299999999999996,
30,JDA O'Connor (AUS),1908-1909,4,8,3,3,0,0,3,1 (1ct 0st),0.375,
31,MB Owens (NZ),1992-1994,8,12,3,3,0,0,3,2 (2ct 0st),0.25,
32,T Panyangara (ZIM),2004-2014,9,16,3,3,0,0,3,2 (2ct 0st),0.187,
33,WGA Parkhouse (ENG),1950-1959,7,13,3,3,0,0,3,1 (1ct 0st),0.23,
34,CH Parkin (ENG),1920-1924,10,17,3,3,0,0,3,2 (2ct 0st),0.17600000000000002,
35,WD Parnell (SA),2010-2017,6,11,3,3,0,0,3,1 (1ct 0st),0.272,
36,CC Passailaigue (WI),1930-1930,1,2,3,3,0,0,3,2 (2ct 0st),1.5,
37,SR Patel (ENG),2012-2015,6,12,3,3,0,0,3,1 (1ct 0st),0.25,
38,AJ Pithey (SA),1957-1965,17,32,3,3,0,0,3,1 (1ct 0st),0.09300000000000001,
39,LE Plunkett (ENG),2005-2014,13,25,3,3,0,0,3,1 (1ct 0st),0.12,
40,R Pollard (ENG),1946-1948,4,7,3,3,0,0,3,1 (1ct 0st),0.428,
41,RM Poore (SA),1896-1896,3,4,3,3,0,0,3,2 (2ct 0st),0.75,
42,SW Poynter (IRE),2019-2019,1,2,3,2,1,2,0,2 (1ct 1st),1.5,
43,C Pringle (NZ),1990-1995,14,24,3,3,0,0,3,1 (1ct 0st),0.125,
44,R Rampaul (WI),2009-2012,18,34,3,3,0,0,3,1 (1ct 0st),0.08800000000000001,
45,BA Richards (SA),1970-1970,4,8,3,3,0,0,3,1 (1ct 0st),0.375,
46,F Ridgway (ENG),1951-1952,5,8,3,3,0,0,3,2 (2ct 0st),0.375,
47,WV Rodriguez (WI),1962-1968,5,10,3,3,0,0,3,2 (2ct 0st),0.3,
48,Sabbir Rahman (BDESH),2016-2018,11,21,3,3,0,0,3,2 (2ct 0st),0.142,
49,Salahuddin (PAK),1965-1969,5,9,3,3,0,0,3,1 (1ct 0st),0.33299999999999996,
0,Saleem Altaf (PAK),1967-1978,21,41,3,3,0,0,3,1 (1ct 0st),0.073,
1,MAR Samarasekera (SL),1988-1991,4,6,3,3,0,0,3,2 (2ct 0st),0.5,
2,Shabbir Ahmed (PAK),2003-2005,10,19,3,3,0,0,3,1 (1ct 0st),0.157,
3,Shadman Islam (BDESH),2018-2019,6,8,3,3,0,0,3,2 (2ct 0st),0.375,
4,WA Shalders (SA),1899-1907,12,23,3,3,0,0,3,1 (1ct 0st),0.13,
5,DP Sibley (ENG),2019-2019,3,5,3,3,0,0,3,1 (1ct 0st),0.6,
6,TAM Siriwardana (SL),2015-2016,5,10,3,3,0,0,3,1 (1ct 0st),0.3,
7,WN Slack (ENG),1986-1986,3,6,3,3,0,0,3,1 (1ct 0st),0.5,
8,JA Small (WI),1928-1930,3,4,3,3,0,0,3,2 (2ct 0st),0.75,
9,VI Smith (SA),1947-1957,9,16,3,3,0,0,3,1 (1ct 0st),0.187,
10,JT Sparling (NZ),1958-1964,11,16,3,3,0,0,3,1 (1ct 0st),0.187,
11,LA Stricker (SA),1910-1912,13,24,3,3,0,0,3,1 (1ct 0st),0.125,
12,Tahir Naqqash (PAK),1982-1985,15,27,3,3,0,0,3,1 (1ct 0st),0.111,
13,LJ Tancred (SA),1902-1913,14,26,3,3,0,0,3,1 (1ct 0st),0.115,
14,G Thomas (AUS),1965-1966,8,15,3,3,0,0,3,1 (1ct 0st),0.2,
15,NFD Thomson (AUS),1877-1877,2,4,3,3,0,0,3,2 (2ct 0st),0.75,
16,NI Thomson (ENG),1964-1965,5,10,3,3,0,0,3,1 (1ct 0st),0.3,
17,T Thushara (SL),2003-2010,10,18,3,3,0,0,3,2 (2ct 0st),0.166,
18,JW Trumble (AUS),1885-1886,7,11,3,3,0,0,3,2 (2ct 0st),0.272,
19,AJ Tudor (ENG),1998-2002,10,17,3,3,0,0,3,2 (2ct 0st),0.17600000000000002,
20,EA van der Merwe (SA),1929-1936,2,3,3,3,0,3,0,2 (2ct 0st),1.0,
21,R Vijay Bharadwaj (INDIA),1999-2000,3,5,3,3,0,0,3,2 (2ct 0st),0.6,
22,GE Vivian (NZ),1965-1972,5,10,3,3,0,0,3,1 (1ct 0st),0.3,
23,KA Walter (SA),1961-1961,2,4,3,3,0,0,3,1 (1ct 0st),0.75,
24,A Ward (ENG),1969-1976,5,9,3,3,0,0,3,2 (2ct 0st),0.33299999999999996,
25,PF Warner (ENG),1899-1912,15,28,3,3,0,0,3,2 (2ct 0st),0.107,
26,JA Warrican (WI),2015-2019,8,13,3,3,0,0,3,1 (1ct 0st),0.23,
27,DM Washington (WI),2005-2005,1,2,3,3,0,0,3,2 (2ct 0st),1.5,
28,GL Weir (NZ),1930-1937,11,16,3,3,0,0,3,1 (1ct 0st),0.187,
29,P Willey (ENG),1976-1986,26,44,3,3,0,0,3,1 (1ct 0st),0.068,
30,H Wood (ENG),1888-1892,4,8,3,2,1,2,0,2 (1ct 1st),0.375,
31,OE Wynne (SA),1948-1950,6,10,3,3,0,0,3,2 (2ct 0st),0.3,
32,V Yadav (INDIA),1993-1993,1,2,3,1,2,1,0,2 (0ct 2st),1.5,
33,Aamer Nazir (PAK),1993-1995,6,12,2,2,0,0,2,2 (2ct 0st),0.166,
34,Aaqib Javed (PAK),1989-1998,22,38,2,2,0,0,2,1 (1ct 0st),0.052000000000000005,
35,Afaq Hussain (PAK),1961-1964,2,4,2,2,0,0,2,1 (1ct 0st),0.5,
36,G Alexander (AUS),1880-1884,2,4,2,2,0,0,2,1 (1ct 0st),0.5,
37,RC Allen (AUS),1887-1887,1,2,2,2,0,0,2,2 (2ct 0st),1.0,
38,GI Allott (NZ),1996-1999,10,16,2,2,0,0,2,1 (1ct 0st),0.125,
39,SW Ambris (WI),2017-2018,6,9,2,2,0,0,2,1 (1ct 0st),0.222,
40,Anamul Haque (BDESH),2013-2014,4,7,2,2,0,0,2,1 (1ct 0st),0.285,
41,ML Apte (INDIA),1952-1953,7,12,2,2,0,0,2,1 (1ct 0st),0.166,
42,Ariful Haque (BDESH),2018-2018,2,4,2,2,0,0,2,1 (1ct 0st),0.5,
43,Arshad Ayub (INDIA),1987-1989,13,24,2,2,0,0,2,1 (1ct 0st),0.083,
44,B Arun (INDIA),1986-1987,2,3,2,2,0,0,2,1 (1ct 0st),0.6659999999999999,
45,Asghar Afghan (AFG),2018-2019,4,7,2,2,0,0,2,1 (1ct 0st),0.285,
46,TD Astle (NZ),2012-2019,4,8,2,2,0,0,2,1 (1ct 0st),0.25,
47,Ata-ur-Rehman (PAK),1992-1996,13,23,2,2,0,0,2,1 (1ct 0st),0.086,
48,ES Atkinson (WI),1958-1959,8,15,2,2,0,0,2,1 (1ct 0st),0.133,
49,RA Austin (WI),1978-1978,2,4,2,2,0,0,2,1 (1ct 0st),0.5,
0,S Badrinath (INDIA),2010-2010,2,3,2,2,0,0,2,1 (1ct 0st),0.6659999999999999,
1,L Baichan (WI),1975-1976,3,6,2,2,0,0,2,2 (2ct 0st),0.33299999999999996,
2,EAE Baptiste (WI),1983-1990,10,20,2,2,0,0,2,1 (1ct 0st),0.1,
3,F Barratt (ENG),1929-1930,5,8,2,2,0,0,2,1 (1ct 0st),0.25,
4,EL Bartlett (WI),1928-1931,5,7,2,2,0,0,2,1 (1ct 0st),0.285,
5,Bazid Khan (PAK),2005-2005,1,2,2,2,0,0,2,2 (2ct 0st),1.0,
6,DD Beard (NZ),1952-1956,4,7,2,2,0,0,2,2 (2ct 0st),0.285,
7,R Beaumont (SA),1912-1914,5,7,2,2,0,0,2,1 (1ct 0st),0.285,
8,DW Begbie (SA),1948-1950,5,8,2,2,0,0,2,1 (1ct 0st),0.25,
9,KCG Benjamin (WI),1992-1998,26,50,2,2,0,0,2,1 (1ct 0st),0.04,
10,R Berry (ENG),1950-1950,2,4,2,2,0,0,2,2 (2ct 0st),0.5,
11,MP Bicknell (ENG),1993-2003,4,7,2,2,0,0,2,1 (1ct 0st),0.285,
12,Bilal Asif (PAK),2018-2018,5,10,2,2,0,0,2,2 (2ct 0st),0.2,
13,JM Bird (AUS),2012-2017,9,17,2,2,0,0,2,1 (1ct 0st),0.11699999999999999,
14,DD Blackie (AUS),1928-1929,3,6,2,2,0,0,2,2 (2ct 0st),0.33299999999999996,
15,RJ Blakey (ENG),1993-1993,2,2,2,2,0,2,0,1 (1ct 0st),1.0,
16,DE Bollinger (AUS),2009-2010,12,23,2,2,0,0,2,1 (1ct 0st),0.086,
17,JB Bolus (ENG),1963-1964,7,14,2,2,0,0,2,1 (1ct 0st),0.142,
18,SG Borthwick (ENG),2014-2014,1,2,2,2,0,0,2,2 (2ct 0st),1.0,
19,WE Bowes (ENG),1932-1946,15,29,2,2,0,0,2,1 (1ct 0st),0.068,
20,EH Bowley (ENG),1929-1930,5,8,2,2,0,0,2,1 (1ct 0st),0.25,
21,NW Bracken (AUS),2003-2005,5,10,2,2,0,0,2,1 (1ct 0st),0.2,
22,WP Bradburn (NZ),1964-1964,2,4,2,2,0,0,2,1 (1ct 0st),0.5,
23,WH Brann (SA),1922-1923,3,6,2,2,0,0,2,1 (1ct 0st),0.33299999999999996,
24,EH Bromley (AUS),1933-1934,2,3,2,2,0,0,2,1 (1ct 0st),0.6659999999999999,
25,CP Buckenham (ENG),1910-1910,4,8,2,2,0,0,2,1 (1ct 0st),0.25,
26,FJ Burton (AUS),1887-1888,2,4,2,1,1,0,1,1 (1ct 0st),0.5,
27,TB Burtt (NZ),1947-1953,10,14,2,2,0,0,2,1 (1ct 0st),0.142,
28,HR Butt (ENG),1896-1896,3,6,2,1,1,1,0,1 (1ct 0st),0.33299999999999996,
29,CG Butts (WI),1985-1988,7,12,2,2,0,0,2,1 (1ct 0st),0.166,
30,FJ Cameron (NZ),1961-1965,19,35,2,2,0,0,2,1 (1ct 0st),0.057,
31,J Cameron-Dow (IRE),2019-2019,1,2,2,2,0,0,2,2 (2ct 0st),1.0,
32,PH Carlson (AUS),1979-1979,2,4,2,2,0,0,2,1 (1ct 0st),0.5,
33,CP Carter (SA),1912-1924,10,16,2,2,0,0,2,1 (1ct 0st),0.125,
34,TW Cartwright (ENG),1964-1965,5,9,2,2,0,0,2,2 (2ct 0st),0.222,
35,B Casson (AUS),2008-2008,1,2,2,2,0,0,2,2 (2ct 0st),1.0,
36,R Chandrika (WI),2015-2016,5,7,2,2,0,0,2,2 (2ct 0st),0.285,
37,TM Chappell (AUS),1981-1981,3,6,2,2,0,0,2,1 (1ct 0st),0.33299999999999996,
38,ST Clarke (WI),1978-1982,11,19,2,2,0,0,2,1 (1ct 0st),0.105,
39,SHM Colah (INDIA),1932-1933,2,4,2,2,0,0,2,2 (2ct 0st),0.5,
40,JB Commins (SA),1994-1995,3,6,2,2,0,0,2,1 (1ct 0st),0.33299999999999996,
41,BB Cooper (AUS),1877-1877,1,2,2,2,0,0,2,2 (2ct 0st),1.0,
42,TA Copeland (AUS),2011-2011,3,6,2,2,0,0,2,1 (1ct 0st),0.33299999999999996,
43,RMH Cottam (ENG),1969-1973,4,8,2,2,0,0,2,1 (1ct 0st),0.25,
44,ID Craig (AUS),1953-1958,11,20,2,2,0,0,2,1 (1ct 0st),0.1,
45,ML Cummins (WI),2016-2019,14,23,2,2,0,0,2,1 (1ct 0st),0.086,
46,SM Curran (ENG),2018-2019,14,27,2,2,0,0,2,2 (2ct 0st),0.07400000000000001,
47,WR Cuttell (ENG),1899-1899,2,4,2,2,0,0,2,2 (2ct 0st),0.5,
48,LA Dawson (ENG),2016-2017,3,5,2,2,0,0,2,2 (2ct 0st),0.4,
49,H Dean (ENG),1912-1912,3,5,2,2,0,0,2,1 (1ct 0st),0.4,
0,CS Dempster (NZ),1930-1933,10,15,2,2,0,0,2,1 (1ct 0st),0.133,
1,XJ Doherty (AUS),2010-2013,4,6,2,2,0,0,2,2 (2ct 0st),0.33299999999999996,
2,H Donnan (AUS),1892-1896,5,9,2,2,0,0,2,1 (1ct 0st),0.222,
3,RR Dower (SA),1899-1899,1,2,2,2,0,0,2,1 (1ct 0st),1.0,
4,VC Drakes (WI),2002-2004,12,23,2,2,0,0,2,1 (1ct 0st),0.086,
5,JP Duminy (SA),1927-1929,3,6,2,2,0,0,2,1 (1ct 0st),0.33299999999999996,
6,JA Dunning (NZ),1933-1937,4,7,2,2,0,0,2,1 (1ct 0st),0.285,
7,JH du Preez (SA),1967-1967,2,4,2,2,0,0,2,1 (1ct 0st),0.5,
8,CJ Eady (AUS),1896-1902,2,4,2,2,0,0,2,1 (1ct 0st),0.5,
9,Ehteshamuddin (PAK),1979-1982,5,8,2,2,0,0,2,1 (1ct 0st),0.25,
10,GD Elliott (NZ),2008-2009,5,9,2,2,0,0,2,2 (2ct 0st),0.222,
11,RM Ellison (ENG),1984-1986,11,22,2,2,0,0,2,1 (1ct 0st),0.09,
12,SH Emery (AUS),1912-1912,4,5,2,2,0,0,2,1 (1ct 0st),0.4,
13,WS Farrer (SA),1962-1964,6,12,2,2,0,0,2,1 (1ct 0st),0.166,
14,Fazl-e-Akbar (PAK),1998-2004,5,8,2,2,0,0,2,1 (1ct 0st),0.25,
15,JP Fellows-Smith (SA),1960-1960,4,7,2,2,0,0,2,1 (1ct 0st),0.285,
16,MVT Fernando (SL),2016-2019,7,12,2,2,0,0,2,1 (1ct 0st),0.166,
17,CG Fichardt (SA),1892-1896,2,3,2,2,0,0,2,1 (1ct 0st),0.6659999999999999,
18,W Flowers (ENG),1884-1893,8,15,2,2,0,0,2,1 (1ct 0st),0.133,
19,TJ Friend (ZIM),2001-2004,13,19,2,2,0,0,2,1 (1ct 0st),0.105,
20,LV Garrick (WI),2001-2001,1,2,2,2,0,0,2,1 (1ct 0st),1.0,
21,C Gladwin (ENG),1947-1949,8,15,2,2,0,0,2,1 (1ct 0st),0.133,
22,RA Gleeson (SA),1896-1896,1,2,2,2,0,0,2,1 (1ct 0st),1.0,
23,CD Gopinath (INDIA),1951-1960,8,14,2,2,0,0,2,1 (1ct 0st),0.142,
24,GF Grace (ENG),1880-1880,1,2,2,2,0,0,2,2 (2ct 0st),1.0,
25,R Graham (SA),1899-1899,2,4,2,2,0,0,2,2 (2ct 0st),0.5,
26,A Greenwood (ENG),1877-1877,2,4,2,2,0,0,2,1 (1ct 0st),0.5,
27,GM Guard (INDIA),1958-1960,2,4,2,2,0,0,2,2 (2ct 0st),0.5,
28,S Guha (INDIA),1967-1969,4,8,2,2,0,0,2,1 (1ct 0st),0.25,
29,DA Gunawardene (SL),1999-2005,6,9,2,2,0,0,2,1 (1ct 0st),0.222,
30,Gursharan Singh (INDIA),1990-1990,1,2,2,2,0,0,2,1 (1ct 0st),1.0,
31,JW Guy (NZ),1955-1961,12,15,2,2,0,0,2,1 (1ct 0st),0.133,
32,JR Hammond (AUS),1973-1973,5,10,2,2,0,0,2,2 (2ct 0st),0.2,
33,Lord Harris (ENG),1879-1884,4,7,2,2,0,0,2,1 (1ct 0st),0.285,
34,JC Hartley (ENG),1906-1906,2,3,2,2,0,0,2,1 (1ct 0st),0.6659999999999999,
35,MJ Haslam (NZ),1992-1995,4,6,2,2,0,0,2,2 (2ct 0st),0.33299999999999996,
36,EG Hayes (ENG),1906-1912,5,10,2,2,0,0,2,1 (1ct 0st),0.2,
37,RGA Headley (WI),1973-1973,2,4,2,2,0,0,2,1 (1ct 0st),0.5,
38,CW Henderson (SA),2001-2002,7,14,2,2,0,0,2,1 (1ct 0st),0.142,
39,O Henry (SA),1992-1993,3,5,2,2,0,0,2,2 (2ct 0st),0.4,
40,JC Hill (AUS),1953-1955,3,5,2,2,0,0,2,1 (1ct 0st),0.4,
41,DE Hoare (AUS),1961-1961,1,2,2,2,0,0,2,1 (1ct 0st),1.0,
42,TG Hogan (AUS),1983-1984,7,11,2,2,0,0,2,1 (1ct 0st),0.18100000000000002,
43,WE Hollies (ENG),1935-1950,13,23,2,2,0,0,2,1 (1ct 0st),0.086,
44,BC Hollioake (ENG),1997-1998,2,4,2,2,0,0,2,1 (1ct 0st),0.5,
45,L Hone (ENG),1879-1879,1,2,2,2,0,2,0,2 (2ct 0st),1.0,
46,MJ Horton (ENG),1959-1959,2,4,2,2,0,0,2,1 (1ct 0st),0.5,
47,R Howorth (ENG),1947-1948,5,10,2,2,0,0,2,1 (1ct 0st),0.2,
48,A Hurwood (AUS),1930-1931,2,4,2,2,0,0,2,2 (2ct 0st),0.5,
49,RC Irani (ENG),1996-1999,3,5,2,2,0,0,2,2 (2ct 0st),0.4,
0,Irfan Fazil (PAK),2000-2000,1,2,2,2,0,0,2,1 (1ct 0st),1.0,
1,BL Irvine (SA),1970-1970,4,8,2,2,0,0,2,1 (1ct 0st),0.25,
2,JB Iverson (AUS),1950-1951,5,10,2,2,0,0,2,1 (1ct 0st),0.2,
3,RJD Jamshedji (INDIA),1933-1933,1,2,2,2,0,0,2,2 (2ct 0st),1.0,
4,MP Jarvis (ZIM),1992-1994,5,8,2,2,0,0,2,1 (1ct 0st),0.25,
5,PW Jarvis (ENG),1988-1993,9,16,2,2,0,0,2,1 (1ct 0st),0.125,
6,MDUS Jayasundera (SL),2015-2015,2,4,2,2,0,0,2,1 (1ct 0st),0.5,
7,VB John (SL),1983-1984,6,9,2,2,0,0,2,1 (1ct 0st),0.222,
8,LJ Johnson (AUS),1948-1948,1,2,2,2,0,0,2,2 (2ct 0st),1.0,
9,Jubair Hossain (BDESH),2014-2015,6,9,2,2,0,0,2,1 (1ct 0st),0.222,
10,H Jupp (ENG),1877-1877,2,4,2,2,0,0,2,2 (2ct 0st),0.5,
11,BR Jurangpathy (SL),1985-1986,2,3,2,2,0,0,2,2 (2ct 0st),0.6659999999999999,
12,S Kalavitigoda (SL),2005-2005,1,1,2,2,0,0,2,2 (2ct 0st),2.0,
13,LWS Kaluperuma (SL),1982-1982,2,4,2,2,0,0,2,2 (2ct 0st),0.5,
14,M Kartik (INDIA),2000-2004,8,15,2,2,0,0,2,1 (1ct 0st),0.133,
15,TK Kendall (AUS),1877-1877,2,4,2,2,0,0,2,1 (1ct 0st),0.5,
16,RJ Kennedy (NZ),1996-1996,4,8,2,2,0,0,2,1 (1ct 0st),0.25,
17,Khaled Mahmud (BDESH),2001-2003,12,17,2,2,0,0,2,1 (1ct 0st),0.11699999999999999,
18,ET Killick (ENG),1929-1929,2,4,2,2,0,0,2,1 (1ct 0st),0.5,
19,LA King (WI),1962-1968,2,4,2,2,0,0,2,1 (1ct 0st),0.5,
20,RD King (WI),1999-2005,19,34,2,2,0,0,2,1 (1ct 0st),0.057999999999999996,
21,RK Kleinveldt (SA),2012-2013,4,7,2,2,0,0,2,1 (1ct 0st),0.285,
22,P Kumar (INDIA),2011-2011,6,11,2,2,0,0,2,2 (2ct 0st),0.18100000000000002,
23,VV Kumar (INDIA),1961-1961,2,4,2,2,0,0,2,1 (1ct 0st),0.5,
24,GA Lamb (ZIM),2011-2011,1,2,2,2,0,0,2,1 (1ct 0st),1.0,
25,CK Langeveldt (SA),2005-2006,6,11,2,2,0,0,2,1 (1ct 0st),0.18100000000000002,
26,GB Lawrence (SA),1961-1962,5,10,2,2,0,0,2,2 (2ct 0st),0.2,
27,WS Lees (ENG),1906-1906,5,9,2,2,0,0,2,1 (1ct 0st),0.222,
28,IB Leggat (NZ),1954-1954,1,2,2,2,0,0,2,2 (2ct 0st),1.0,
29,PJ Loader (ENG),1954-1959,13,26,2,2,0,0,2,1 (1ct 0st),0.076,
30,Hon.A Lyttelton (ENG),1880-1884,4,7,2,2,0,2,0,1 (1ct 0st),0.285,
31,AB McDonald (AUS),2009-2009,4,7,2,2,0,0,2,1 (1ct 0st),0.285,
32,NC McGarrell (WI),2001-2001,4,8,2,2,0,0,2,1 (1ct 0st),0.25,
33,PG McShane (AUS),1885-1888,3,5,2,2,0,0,2,1 (1ct 0st),0.4,
34,NJ Maddinson (AUS),2016-2016,3,6,2,2,0,0,2,1 (1ct 0st),0.33299999999999996,
35,IS Madray (WI),1958-1958,2,4,2,2,0,0,2,1 (1ct 0st),0.5,
36,JN Maguire (AUS),1983-1984,3,5,2,2,0,0,2,2 (2ct 0st),0.4,
37,AO Malhotra (INDIA),1982-1985,7,11,2,2,0,0,2,1 (1ct 0st),0.18100000000000002,
38,AL Mann (AUS),1977-1978,4,7,2,2,0,0,2,1 (1ct 0st),0.285,
39,DA Marillier (ZIM),2000-2002,5,9,2,2,0,0,2,1 (1ct 0st),0.222,
40,Marshall Ayub (BDESH),2013-2014,3,4,2,2,0,0,2,1 (1ct 0st),0.5,
41,F Martin (ENG),1890-1892,2,4,2,2,0,0,2,1 (1ct 0st),0.5,
42,FR Martin (WI),1928-1931,9,12,2,2,0,0,2,1 (1ct 0st),0.166,
43,SW Masakadza (ZIM),2012-2014,5,9,2,2,0,0,2,1 (1ct 0st),0.222,
44,AM Matheson (NZ),1930-1931,2,3,2,2,0,0,2,2 (2ct 0st),0.6659999999999999,
45,ER Mayne (AUS),1912-1921,4,7,2,2,0,0,2,2 (2ct 0st),0.285,
46,M Mbangwa (ZIM),1996-2000,15,25,2,2,0,0,2,1 (1ct 0st),0.08,
47,JA McCollum (IRE),2019-2019,2,4,2,2,0,0,2,1 (1ct 0st),0.5,
48,Mehrab Hossain jnr (BDESH),2007-2009,7,11,2,2,0,0,2,1 (1ct 0st),0.18100000000000002,
49,BAW Mendis (SL),2008-2014,19,31,2,2,0,0,2,1 (1ct 0st),0.064,
0,WE Merritt (NZ),1930-1931,6,10,2,2,0,0,2,2 (2ct 0st),0.2,
1,AG Milkha Singh (INDIA),1960-1961,4,7,2,2,0,0,2,1 (1ct 0st),0.285,
2,WH Milton (SA),1889-1892,3,4,2,2,0,0,2,1 (1ct 0st),0.5,
3,F Mitchell (ENG/SA),1899-1912,5,8,2,2,0,0,2,1 (1ct 0st),0.25,
4,Mohammad Mithun (BDESH),2018-2019,7,10,2,2,0,0,2,1 (1ct 0st),0.2,
5,Mohammad Nabi (AFG),2018-2019,3,5,2,2,0,0,2,2 (2ct 0st),0.4,
6,Mohammad Nawaz (3) (PAK),2016-2016,3,6,2,2,0,0,2,1 (1ct 0st),0.33299999999999996,
7,AM Moir (NZ),1951-1959,17,21,2,2,0,0,2,1 (1ct 0st),0.095,
8,Mosaddek Hossain (BDESH),2017-2019,3,5,2,2,0,0,2,1 (1ct 0st),0.4,
9,SA Muller (AUS),1999-1999,2,4,2,2,0,0,2,1 (1ct 0st),0.5,
10,N M'shangwe (ZIM),2014-2014,2,4,2,2,0,0,2,1 (1ct 0st),0.5,
11,S Muthusamy (SA),2019-2019,2,3,2,2,0,0,2,2 (2ct 0st),0.6659999999999999,
12,Naeem Islam (BDESH),2008-2012,8,15,2,2,0,0,2,1 (1ct 0st),0.133,
13,Nafees Iqbal (BDESH),2004-2006,11,15,2,2,0,0,2,1 (1ct 0st),0.133,
14,MV Nagamootoo (WI),2000-2002,5,8,2,2,0,0,2,2 (2ct 0st),0.25,
15,R Nanan (WI),1980-1980,1,2,2,2,0,0,2,2 (2ct 0st),1.0,
16,SP Narine (WI),2012-2013,6,11,2,2,0,0,2,1 (1ct 0st),0.18100000000000002,
17,Najmul Hossain Shanto (BDESH),2017-2018,2,4,2,2,0,0,2,2 (2ct 0st),0.5,
18,RJ Nicol (NZ),2012-2012,2,4,2,2,0,0,2,1 (1ct 0st),0.5,
19,M Nissar (INDIA),1932-1936,6,11,2,2,0,0,2,1 (1ct 0st),0.18100000000000002,
20,JM Noreiga (WI),1971-1971,4,7,2,2,0,0,2,2 (2ct 0st),0.285,
21,RK Nunes (WI),1928-1930,4,5,2,2,0,1,1,1 (1ct 0st),0.4,
22,J Nyumbu (ZIM),2014-2016,3,6,2,2,0,0,2,1 (1ct 0st),0.33299999999999996,
23,NJ O'Brien (IRE),2018-2018,1,2,2,2,0,2,0,2 (2ct 0st),1.0,
24,J O'Connor (ENG),1929-1930,4,8,2,2,0,0,2,2 (2ct 0st),0.25,
25,D Olivier (SA),2017-2019,10,20,2,2,0,0,2,1 (1ct 0st),0.1,
26,DR O'Sullivan (NZ),1973-1976,11,19,2,2,0,0,2,1 (1ct 0st),0.105,
27,LCH Palairet (ENG),1902-1902,2,4,2,2,0,0,2,1 (1ct 0st),0.5,
28,Pankaj Singh (INDIA),2014-2014,2,3,2,2,0,0,2,1 (1ct 0st),0.6659999999999999,
29,NM Parker (NZ),1976-1976,3,6,2,2,0,0,2,1 (1ct 0st),0.33299999999999996,
30,LS Pascoe (AUS),1977-1982,14,27,2,2,0,0,2,1 (1ct 0st),0.07400000000000001,
31,JM Patel (INDIA),1955-1960,7,11,2,2,0,0,2,1 (1ct 0st),0.18100000000000002,
32,MM Patel (ENG),1996-1996,2,4,2,2,0,0,2,2 (2ct 0st),0.5,
33,Yuvraj of Patiala (INDIA),1934-1934,1,2,2,2,0,0,2,1 (1ct 0st),1.0,
34,KMA Paul (WI),2018-2019,3,5,2,2,0,0,2,1 (1ct 0st),0.4,
35,E Peate (ENG),1881-1886,9,15,2,2,0,0,2,1 (1ct 0st),0.133,
36,PDRL Perera (SL),1999-2002,8,14,2,2,0,0,2,1 (1ct 0st),0.142,
37,V Permaul (WI),2012-2015,6,11,2,2,0,0,2,1 (1ct 0st),0.18100000000000002,
38,AL Phehlukwayo (SA),2017-2018,4,8,2,2,0,0,2,1 (1ct 0st),0.25,
39,WTS Porterfield (IRE),2018-2019,3,6,2,2,0,0,2,2 (2ct 0st),0.33299999999999996,
40,JE Pothecary (SA),1960-1960,3,6,2,2,0,0,2,1 (1ct 0st),0.33299999999999996,
41,AD Pougher (ENG),1892-1892,1,2,2,2,0,0,2,1 (1ct 0st),1.0,
42,AW Powell (SA),1899-1899,1,2,2,2,0,0,2,2 (2ct 0st),1.0,
43,WFF Price (ENG),1938-1938,1,2,2,2,0,2,0,2 (2ct 0st),1.0,
44,HLE Promnitz (SA),1927-1928,2,4,2,2,0,0,2,1 (1ct 0st),0.5,
45,G Pullar (ENG),1959-1963,28,50,2,2,0,0,2,1 (1ct 0st),0.04,
46,PM Pushpakumara (SL),2017-2018,4,6,2,2,0,0,2,2 (2ct 0st),0.33299999999999996,
47,AJ Pycroft (ZIM),1992-1992,3,5,2,2,0,0,2,1 (1ct 0st),0.4,
48,CG Rackemann (AUS),1982-1991,12,20,2,2,0,0,2,1 (1ct 0st),0.1,
49,Rahmat Shah (AFG),2018-2019,4,7,2,2,0,0,2,1 (1ct 0st),0.285,
0,RR Ramdass (WI),2005-2005,1,2,2,2,0,0,2,2 (2ct 0st),1.0,
1,S Ranatunga (SL),1994-1997,9,13,2,2,0,0,2,1 (1ct 0st),0.153,
2,Rashid Khan (PAK),1982-1985,4,7,2,2,0,0,2,1 (1ct 0st),0.285,
3,DA Renneberg (AUS),1966-1968,8,15,2,2,0,0,2,1 (1ct 0st),0.133,
4,JB Robertson (SA),1935-1936,3,5,2,2,0,0,2,1 (1ct 0st),0.4,
5,A Rose-Innes (SA),1889-1889,2,3,2,2,0,0,2,2 (2ct 0st),0.6659999999999999,
6,TW Routledge (SA),1892-1896,4,5,2,2,0,0,2,1 (1ct 0st),0.4,
7,VPFA Royle (ENG),1879-1879,1,2,2,2,0,0,2,2 (2ct 0st),1.0,
8,Saleem Jaffar (PAK),1986-1992,14,26,2,2,0,0,2,1 (1ct 0st),0.076,
9,RO Scarlett (WI),1960-1960,3,6,2,2,0,0,2,1 (1ct 0st),0.33299999999999996,
10,BN Schultz (SA),1992-1997,9,15,2,2,0,0,2,1 (1ct 0st),0.133,
11,CP Senanayake (SL),1991-1991,3,6,2,2,0,0,2,1 (1ct 0st),0.33299999999999996,
12,MA Seymour (SA),1963-1970,7,12,2,2,0,0,2,1 (1ct 0st),0.166,
13,Shafiul Islam (BDESH),2010-2017,11,21,2,2,0,0,2,1 (1ct 0st),0.095,
14,OA Shah (ENG),2006-2009,6,9,2,2,0,0,2,1 (1ct 0st),0.222,
15,Shahid Israr (PAK),1976-1976,1,2,2,2,0,2,0,2 (2ct 0st),1.0,
16,A Shahzad (ENG),2010-2010,1,2,2,2,0,0,2,1 (1ct 0st),1.0,
17,G Sharma (INDIA),1985-1990,5,9,2,2,0,0,2,1 (1ct 0st),0.222,
18,DA Sharpe (PAK),1959-1959,3,6,2,2,0,0,2,2 (2ct 0st),0.33299999999999996,
19,JW Sharpe (ENG),1890-1892,3,6,2,2,0,0,2,1 (1ct 0st),0.33299999999999996,
20,PP Shaw (INDIA),2018-2018,2,4,2,2,0,0,2,2 (2ct 0st),0.5,
21,BK Shepherd (AUS),1963-1965,9,18,2,2,0,0,2,1 (1ct 0st),0.111,
22,GH Shepstone (SA),1896-1899,2,3,2,2,0,0,2,2 (2ct 0st),0.6659999999999999,
23,GC Shillingford (WI),1969-1972,7,12,2,2,0,0,2,2 (2ct 0st),0.166,
24,MJF Shrimpton (NZ),1963-1974,10,17,2,2,0,0,2,1 (1ct 0st),0.11699999999999999,
25,Sikandar Raza (ZIM),2013-2018,12,21,2,2,0,0,2,1 (1ct 0st),0.095,
26,ARS Silva (SL),2017-2019,12,23,2,2,0,0,2,1 (1ct 0st),0.086,
27,CEW Silverwood (ENG),1996-2002,6,9,2,2,0,0,2,1 (1ct 0st),0.222,
28,DJ Sincock (AUS),1964-1966,3,5,2,2,0,0,2,2 (2ct 0st),0.4,
29,CK Singh (WI),1960-1960,2,4,2,2,0,0,2,1 (1ct 0st),0.5,
30,VA Singh (WI),2017-2017,3,6,2,2,0,0,2,1 (1ct 0st),0.33299999999999996,
31,CJE Smith (SA),1902-1902,3,6,2,2,0,0,2,2 (2ct 0st),0.33299999999999996,
32,DR Smith (ENG),1961-1962,5,8,2,2,0,0,2,1 (1ct 0st),0.25,
33,FW Smith (SA),1889-1896,3,4,2,2,0,2,0,2 (2ct 0st),0.5,
34,SD Snooke (SA),1907-1907,1,2,2,2,0,0,2,2 (2ct 0st),1.0,
35,Sohail Khan (PAK),2009-2016,9,17,2,2,0,0,2,1 (1ct 0st),0.11699999999999999,
36,Sohail Tanvir (PAK),2007-2007,2,4,2,2,0,0,2,1 (1ct 0st),0.5,
37,SW Sohoni (INDIA),1946-1951,4,6,2,2,0,0,2,1 (1ct 0st),0.33299999999999996,
38,J Southerton (ENG),1877-1877,2,4,2,2,0,0,2,1 (1ct 0st),0.5,
39,GR Stead (NZ),1999-1999,5,9,2,2,0,0,2,1 (1ct 0st),0.222,
40,GB Stevens (AUS),1959-1960,4,8,2,2,0,0,2,1 (1ct 0st),0.25,
41,RB Stewart (SA),1889-1889,1,2,2,2,0,0,2,2 (2ct 0st),1.0,
42,CEL Stuart (WI),2000-2001,6,12,2,2,0,0,2,1 (1ct 0st),0.166,
43,Khaled Ahmed (BDESH),2018-2019,2,3,2,2,0,0,2,1 (1ct 0st),0.6659999999999999,
44,AB Tancred (SA),1889-1889,2,3,2,2,0,0,2,1 (1ct 0st),0.6659999999999999,
45,FW Tate (ENG),1902-1902,1,2,2,2,0,0,2,1 (1ct 0st),1.0,
46,DD Taylor (NZ),1947-1956,3,5,2,2,0,0,2,1 (1ct 0st),0.4,
47,VP Terry (ENG),1984-1984,2,3,2,2,0,0,2,1 (1ct 0st),0.6659999999999999,
48,DT Tiripano (ZIM),2014-2018,7,13,2,2,0,0,2,1 (1ct 0st),0.153,
49,LF Townsend (ENG),1930-1934,4,8,2,2,0,0,2,1 (1ct 0st),0.25,
0,JC Tredwell (ENG),2010-2015,2,4,2,2,0,0,2,1 (1ct 0st),0.5,
1,J Trim (WI),1948-1952,4,8,2,2,0,0,2,1 (1ct 0st),0.25,
2,GB Troup (NZ),1976-1986,15,28,2,2,0,0,2,1 (1ct 0st),0.071,
3,LR Tuckett (SA),1914-1914,1,2,2,2,0,0,2,2 (2ct 0st),1.0,
4,GE Tyldesley (ENG),1921-1929,14,25,2,2,0,0,2,1 (1ct 0st),0.08,
5,ML Udawatte (SL),2018-2018,2,4,2,2,0,0,2,1 (1ct 0st),0.5,
6,P Utseya (ZIM),2004-2013,4,6,2,2,0,0,2,2 (2ct 0st),0.33299999999999996,
7,BH Valentine (ENG),1933-1939,7,13,2,2,0,0,2,1 (1ct 0st),0.153,
8,BV Vitori (ZIM),2011-2013,4,7,2,2,0,0,2,1 (1ct 0st),0.285,
9,E Wainwright (ENG),1893-1898,5,8,2,2,0,0,2,1 (1ct 0st),0.25,
10,FH Walters (AUS),1885-1885,1,1,2,2,0,0,2,2 (2ct 0st),2.0,
11,B Warnapura (SL),1982-1982,4,7,2,2,0,0,2,1 (1ct 0st),0.285,
12,WJ Watson (AUS),1955-1955,4,7,2,2,0,0,2,1 (1ct 0st),0.285,
13,PN Webb (NZ),1980-1980,2,4,2,2,0,0,2,1 (1ct 0st),0.5,
14,AJ Webbe (ENG),1879-1879,1,2,2,2,0,0,2,2 (2ct 0st),1.0,
15,AW Wellard (ENG),1937-1938,2,4,2,2,0,0,2,2 (2ct 0st),0.5,
16,MD Wettimuny (SL),1983-1983,2,3,2,2,0,0,2,2 (2ct 0st),0.6659999999999999,
17,MR Whitney (AUS),1981-1992,12,24,2,2,0,0,2,1 (1ct 0st),0.083,
18,EAV Williams (WI),1939-1948,4,8,2,2,0,0,2,1 (1ct 0st),0.25,
19,Zulqarnain Haider (PAK),2010-2010,1,2,2,2,0,2,0,2 (2ct 0st),1.0,
20,VR Aaron (INDIA),2011-2015,9,15,1,1,0,0,1,1 (1ct 0st),0.066,
21,Abdul Kadir (PAK),1964-1965,4,8,1,0,1,0,0,1 (0ct 1st),0.125,
22,Abu Jayed (BDESH),2018-2019,7,9,1,1,0,0,1,1 (1ct 0st),0.111,
23,HD Ackerman (SA),1998-1998,4,8,1,1,0,0,1,1 (1ct 0st),0.125,
24,MR Adair (IRE),2019-2019,1,2,1,1,0,0,1,1 (1ct 0st),0.5,
25,AR Adams (NZ),2002-2002,1,2,1,1,0,0,1,1 (1ct 0st),0.5,
26,FS Ahangama (SL),1985-1985,3,6,1,1,0,0,1,1 (1ct 0st),0.166,
27,Aizaz Cheema (PAK),2011-2012,7,14,1,1,0,0,1,1 (1ct 0st),0.071,
28,Ali Naqvi (PAK),1997-1998,5,8,1,1,0,0,1,1 (1ct 0st),0.125,
29,IBA Allen (WI),1991-1991,2,3,1,1,0,0,1,1 (1ct 0st),0.33299999999999996,
30,KN Amalean (SL),1986-1988,2,2,1,1,0,0,1,1 (1ct 0st),0.5,
31,JH Anderson (SA),1902-1902,1,2,1,1,0,0,1,1 (1ct 0st),0.5,
32,RW Anderson (NZ),1976-1978,9,16,1,1,0,0,1,1 (1ct 0st),0.062,
33,WM Anderson (NZ),1946-1946,1,1,1,1,0,0,1,1 (1ct 0st),1.0,
34,KV Andrew (ENG),1954-1963,2,3,1,1,0,1,0,1 (1ct 0st),0.33299999999999996,
35,B Andrews (NZ),1973-1974,2,3,1,1,0,0,1,1 (1ct 0st),0.33299999999999996,
36,J Angel (AUS),1993-1995,4,7,1,1,0,0,1,1 (1ct 0st),0.142,
37,ZS Ansari (ENG),2016-2016,3,6,1,1,0,0,1,1 (1ct 0st),0.166,
38,JC Archer (ENG),2019-2019,7,13,1,1,0,0,1,1 (1ct 0st),0.076,
39,Azeem Hafeez (PAK),1983-1985,18,28,1,1,0,0,1,1 (1ct 0st),0.035,
40,FT Badcock (NZ),1930-1933,7,10,1,1,0,0,1,1 (1ct 0st),0.1,
41,SV Bahutule (INDIA),2001-2001,2,3,1,1,0,0,1,1 (1ct 0st),0.33299999999999996,
42,LS Baker (WI),2008-2009,4,7,1,1,0,0,1,1 (1ct 0st),0.142,
43,L Balaji (INDIA),2003-2005,8,15,1,1,0,0,1,1 (1ct 0st),0.066,
44,JC Balderstone (ENG),1976-1976,2,4,1,1,0,0,1,1 (1ct 0st),0.25,
45,JT Ball (ENG),2016-2017,4,6,1,1,0,0,1,1 (1ct 0st),0.166,
46,RT Barber (NZ),1956-1956,1,2,1,1,0,0,1,1 (1ct 0st),0.5,
47,W Barber (ENG),1935-1935,2,4,1,1,0,0,1,1 (1ct 0st),0.25,
48,KJ Barnett (ENG),1988-1989,4,8,1,1,0,0,1,1 (1ct 0st),0.125,
49,JE Barrett (AUS),1890-1890,2,4,1,1,0,0,1,1 (1ct 0st),0.25,
0,HV Baumgartner (SA),1913-1913,1,1,1,1,0,0,1,1 (1ct 0st),1.0,
1,MA Beer (AUS),2011-2012,2,3,1,1,0,0,1,1 (1ct 0st),0.33299999999999996,
2,W Bell (NZ),1954-1954,2,4,1,1,0,0,1,1 (1ct 0st),0.25,
3,DM Bess (ENG),2018-2018,2,4,1,1,0,0,1,1 (1ct 0st),0.25,
4,P Bhandari (INDIA),1955-1956,3,6,1,1,0,0,1,1 (1ct 0st),0.166,
5,BA Bolton (NZ),1959-1959,2,2,1,1,0,0,1,1 (1ct 0st),0.5,
6,JT Botten (SA),1965-1965,3,6,1,1,0,0,1,1 (1ct 0st),0.166,
7,MP Bowden (ENG),1889-1889,2,4,1,1,0,1,0,1 (1ct 0st),0.25,
8,BP Bracewell (NZ),1978-1985,6,11,1,1,0,0,1,1 (1ct 0st),0.09,
9,DH Brain (ZIM),1992-1995,9,16,1,1,0,0,1,1 (1ct 0st),0.062,
10,GR Breese (WI),2002-2002,1,2,1,1,0,0,1,1 (1ct 0st),0.5,
11,DV Brennan (ENG),1951-1951,2,4,1,0,1,0,0,1 (0ct 1st),0.25,
12,GB Brent (ZIM),1999-2001,4,6,1,1,0,0,1,1 (1ct 0st),0.166,
13,AW Briscoe (SA),1935-1939,2,3,1,1,0,0,1,1 (1ct 0st),0.33299999999999996,
14,HR Bromley-Davenport (ENG),1896-1899,4,8,1,1,0,0,1,1 (1ct 0st),0.125,
15,D Brookes (ENG),1948-1948,1,2,1,1,0,0,1,1 (1ct 0st),0.5,
16,A Brown (ENG),1961-1961,2,4,1,1,0,0,1,1 (1ct 0st),0.25,
17,SJE Brown (ENG),1996-1996,1,2,1,1,0,0,1,1 (1ct 0st),0.5,
18,CR Browne (WI),1928-1930,4,6,1,1,0,0,1,1 (1ct 0st),0.166,
19,CGD Burger (SA),1958-1958,2,4,1,1,0,0,1,1 (1ct 0st),0.25,
20,RP Burl (ZIM),2017-2017,1,1,1,1,0,0,1,1 (1ct 0st),1.0,
21,MG Burmester (ZIM),1992-1992,3,5,1,1,0,0,1,1 (1ct 0st),0.2,
22,IP Butchart (ZIM),1995-1995,1,2,1,1,0,0,1,1 (1ct 0st),0.5,
23,HJ Butler (ENG),1947-1948,2,4,1,1,0,0,1,1 (1ct 0st),0.25,
24,IW Callen (AUS),1978-1978,1,2,1,1,0,0,1,1 (1ct 0st),0.5,
25,GD Campbell (AUS),1989-1990,4,8,1,1,0,0,1,1 (1ct 0st),0.125,
26,GM Carew (WI),1935-1949,4,8,1,1,0,0,1,1 (1ct 0st),0.125,
27,HW Chapman (SA),1914-1921,2,4,1,1,0,0,1,1 (1ct 0st),0.25,
28,PP Chawla (INDIA),2006-2012,3,6,1,1,0,0,1,1 (1ct 0st),0.166,
29,GA Chevalier (SA),1970-1970,1,2,1,1,0,0,1,1 (1ct 0st),0.5,
30,JH Childs (ENG),1988-1988,2,3,1,1,0,0,1,1 (1ct 0st),0.33299999999999996,
31,R Clarke (ENG),2003-2003,2,4,1,1,0,0,1,1 (1ct 0st),0.25,
32,JC Clay (ENG),1935-1935,1,2,1,1,0,0,1,1 (1ct 0st),0.5,
33,SK Coen (SA),1927-1928,2,4,1,1,0,0,1,1 (1ct 0st),0.25,
34,LJ Coldwell (ENG),1962-1964,7,14,1,1,0,0,1,1 (1ct 0st),0.071,
35,DJ Colley (AUS),1972-1972,3,6,1,1,0,0,1,1 (1ct 0st),0.166,
36,JMM Commaille (SA),1910-1928,12,19,1,1,0,0,1,1 (1ct 0st),0.052000000000000005,
37,DP Conyngham (SA),1923-1923,1,2,1,1,0,0,1,1 (1ct 0st),0.5,
38,AHC Cooper (SA),1913-1913,1,1,1,1,0,0,1,1 (1ct 0st),1.0,
39,WH Cooper (AUS),1881-1884,2,4,1,1,0,0,1,1 (1ct 0st),0.25,
40,GA Cope (ENG),1977-1978,3,5,1,1,0,0,1,1 (1ct 0st),0.2,
41,WH Copson (ENG),1939-1947,3,6,1,1,0,0,1,1 (1ct 0st),0.166,
42,JT Cottam (AUS),1887-1887,1,2,1,1,0,0,1,1 (1ct 0st),0.5,
43,JL Cox (SA),1913-1914,3,4,1,1,0,0,1,1 (1ct 0st),0.25,
44,J Cranston (ENG),1890-1890,1,2,1,1,0,0,1,1 (1ct 0st),0.5,
45,WPA Crawford (AUS),1956-1956,4,8,1,1,0,0,1,1 (1ct 0st),0.125,
46,IB Cromb (NZ),1931-1932,5,7,1,1,0,0,1,1 (1ct 0st),0.142,
47,AC Cummins (WI),1993-1994,5,9,1,1,0,0,1,1 (1ct 0st),0.111,
48,RS Cunis (NZ),1964-1972,20,38,1,1,0,0,1,1 (1ct 0st),0.026000000000000002,
49,KM Dabengwa (ZIM),2005-2005,3,4,1,1,0,0,1,1 (1ct 0st),0.25,
0,A Dananjaya (SL),2018-2019,6,12,1,1,0,0,1,1 (1ct 0st),0.083,
1,HT Dani (INDIA),1952-1952,1,2,1,1,0,0,1,1 (1ct 0st),0.5,
2,BA Davis (WI),1965-1965,4,7,1,1,0,0,1,1 (1ct 0st),0.142,
3,FI de Caires (WI),1930-1930,3,6,1,1,0,0,1,1 (1ct 0st),0.166,
4,M de Lange (SA),2011-2012,2,4,1,1,0,0,1,1 (1ct 0st),0.25,
5,EW Dempster (NZ),1953-1954,5,9,1,1,0,0,1,1 (1ct 0st),0.111,
6,SI de Saram (SL),1999-2000,4,8,1,1,0,0,1,1 (1ct 0st),0.125,
7,SKL de Silva (SL),1997-1997,3,4,1,1,0,1,0,1 (1ct 0st),0.25,
8,WRS de Silva (SL),2002-2007,3,6,1,1,0,0,1,1 (1ct 0st),0.166,
9,F de Wet (SA),2009-2010,2,4,1,1,0,0,1,1 (1ct 0st),0.25,
10,R Dhanraj (WI),1994-1996,4,8,1,1,0,0,1,1 (1ct 0st),0.125,
11,CD Dixon (SA),1914-1914,1,2,1,1,0,0,1,1 (1ct 0st),0.5,
12,HE Dollery (ENG),1947-1950,4,8,1,1,0,0,1,1 (1ct 0st),0.125,
13,A Dolphin (ENG),1921-1921,1,2,1,1,0,1,0,1 (1ct 0st),0.5,
14,A Ducat (ENG),1921-1921,1,2,1,1,0,0,1,1 (1ct 0st),0.5,
15,BM Duckett (ENG),2016-2016,4,8,1,1,0,0,1,1 (1ct 0st),0.125,
16,T Duffin (ZIM),2005-2005,2,3,1,1,0,0,1,1 (1ct 0st),0.33299999999999996,
17,OR Dunell (SA),1889-1889,2,3,1,1,0,0,1,1 (1ct 0st),0.33299999999999996,
18,JF du Toit (SA),1892-1892,1,1,1,1,0,0,1,1 (1ct 0st),1.0,
19,G Dymock (AUS),1974-1980,21,35,1,1,0,0,1,1 (1ct 0st),0.027999999999999997,
20,Ebadat Hossain (BDESH),2019-2019,4,4,1,1,0,0,1,1 (1ct 0st),0.25,
21,JD Edwards (AUS),1888-1888,3,4,1,1,0,0,1,1 (1ct 0st),0.25,
22,Elias Sunny (BDESH),2011-2013,4,7,1,1,0,0,1,1 (1ct 0st),0.142,
23,S Elworthy (SA),1998-2002,4,8,1,1,0,0,1,1 (1ct 0st),0.125,
24,L Embuldeniya (SL),2019-2019,5,9,1,1,0,0,1,1 (1ct 0st),0.111,
25,Enamul Haque (BDESH),2001-2003,10,13,1,1,0,0,1,1 (1ct 0st),0.076,
26,CN Evans (ZIM),1996-2003,3,4,1,1,0,0,1,1 (1ct 0st),0.25,
27,GM Ewing (ZIM),2003-2005,3,5,1,1,0,0,1,1 (1ct 0st),0.2,
28,Fahim Muntasir (BDESH),2002-2002,3,4,1,1,0,0,1,1 (1ct 0st),0.25,
29,K Farnes (ENG),1934-1939,15,27,1,1,0,0,1,1 (1ct 0st),0.037000000000000005,
30,KHRK Fernando (SL),2002-2002,2,3,1,1,0,0,1,1 (1ct 0st),0.33299999999999996,
31,LB Fishlock (ENG),1936-1947,4,7,1,1,0,0,1,1 (1ct 0st),0.142,
32,BC Francis (AUS),1972-1972,3,6,1,1,0,0,1,1 (1ct 0st),0.166,
33,HH Francis (SA),1899-1899,2,4,1,1,0,0,1,1 (1ct 0st),0.25,
34,JER Gallian (ENG),1995-1995,3,4,1,1,0,0,1,1 (1ct 0st),0.25,
35,A Gandotra (INDIA),1969-1969,2,4,1,1,0,0,1,1 (1ct 0st),0.25,
36,BBM Gaskin (WI),1948-1948,2,4,1,1,0,0,1,1 (1ct 0st),0.25,
37,RA Gaunt (AUS),1958-1964,3,5,1,1,0,0,1,1 (1ct 0st),0.2,
38,GL Gibbs (WI),1955-1955,1,2,1,1,0,0,1,1 (1ct 0st),0.5,
39,WF Giffen (AUS),1887-1892,3,5,1,1,0,0,1,1 (1ct 0st),0.2,
40,MR Gillespie (NZ),2007-2012,5,8,1,1,0,0,1,1 (1ct 0st),0.125,
41,H Gimblett (ENG),1936-1939,3,6,1,1,0,0,1,1 (1ct 0st),0.166,
42,N Gordon (SA),1938-1939,5,8,1,1,0,0,1,1 (1ct 0st),0.125,
43,AR Gover (ENG),1936-1946,4,7,1,1,0,0,1,1 (1ct 0st),0.142,
44,EM Grace (ENG),1880-1880,1,2,1,1,0,0,1,1 (1ct 0st),0.5,
45,T Greenhough (ENG),1959-1960,4,8,1,1,0,0,1,1 (1ct 0st),0.125,
46,EJ Gregory (AUS),1877-1877,1,2,1,1,0,0,1,1 (1ct 0st),0.5,
47,RG Gregory (AUS),1937-1937,2,4,1,1,0,0,1,1 (1ct 0st),0.25,
48,MG Grell (WI),1930-1930,1,2,1,1,0,0,1,1 (1ct 0st),0.5,
49,CG Halse (SA),1964-1964,3,6,1,1,0,0,1,1 (1ct 0st),0.166,
0,RA Hamence (AUS),1947-1948,3,6,1,1,0,0,1,1 (1ct 0st),0.166,
1,J Hardstaff snr (ENG),1907-1908,5,10,1,1,0,0,1,1 (1ct 0st),0.1,
2,SR Harmer (SA),2015-2015,5,8,1,1,0,0,1,1 (1ct 0st),0.125,
3,TA Harris (SA),1947-1949,3,6,1,1,0,0,1,1 (1ct 0st),0.166,
4,J Harry (AUS),1895-1895,1,2,1,1,0,0,1,1 (1ct 0st),0.5,
5,MJ Hartigan (AUS),1908-1908,2,4,1,1,0,0,1,1 (1ct 0st),0.25,
6,Haseeb Ahsan (PAK),1958-1962,12,20,1,1,0,0,1,1 (1ct 0st),0.05,
7,Hashmatullah Shahidi (AFG),2018-2019,3,5,1,1,0,0,1,1 (1ct 0st),0.2,
8,Hasibul Hossain (BDESH),2000-2001,5,6,1,1,0,0,1,1 (1ct 0st),0.166,
9,JW Hastings (AUS),2012-2012,1,2,1,1,0,0,1,1 (1ct 0st),0.5,
10,A Hearne (ENG),1892-1892,1,2,1,1,0,0,1,1 (1ct 0st),0.5,
11,M Henderson (NZ),1930-1930,1,2,1,1,0,0,1,1 (1ct 0st),0.5,
12,MC Henriques (AUS),2013-2016,4,7,1,1,0,0,1,1 (1ct 0st),0.142,
13,PA Hibbert (AUS),1977-1977,1,2,1,1,0,0,1,1 (1ct 0st),0.5,
14,A Hill (ENG),1877-1877,2,4,1,1,0,0,1,1 (1ct 0st),0.25,
15,AJL Hill (ENG),1896-1896,3,6,1,1,0,0,1,1 (1ct 0st),0.166,
16,MJ Hilton (ENG),1950-1952,4,6,1,1,0,0,1,1 (1ct 0st),0.166,
17,ELG Hoad (WI),1928-1933,4,5,1,1,0,0,1,1 (1ct 0st),0.2,
18,GB Hogg (AUS),1996-2008,7,14,1,1,0,0,1,1 (1ct 0st),0.071,
19,JM Holland (AUS),2016-2018,4,8,1,1,0,0,1,1 (1ct 0st),0.125,
20,KW Hough (NZ),1959-1959,2,2,1,1,0,0,1,1 (1ct 0st),0.5,
21,WA Hunt (AUS),1932-1932,1,2,1,1,0,0,1,1 (1ct 0st),0.5,
22,LG Hylton (WI),1935-1939,6,12,1,1,0,0,1,1 (1ct 0st),0.083,
23,Iftikhar Ahmed (PAK),2016-2019,3,4,1,1,0,0,1,1 (1ct 0st),0.25,
24,AP Igglesden (ENG),1989-1994,3,5,1,1,0,0,1,1 (1ct 0st),0.2,
25,DEJ Ironside (SA),1953-1954,3,5,1,1,0,0,1,1 (1ct 0st),0.2,
26,Israr Ali (PAK),1952-1959,4,7,1,1,0,0,1,1 (1ct 0st),0.142,
27,SD Jack (SA),1994-1995,2,4,1,1,0,0,1,1 (1ct 0st),0.25,
28,HL Jackson (ENG),1949-1961,2,4,1,1,0,0,1,1 (1ct 0st),0.25,
29,CL Johnson (SA),1896-1896,1,1,1,1,0,0,1,1 (1ct 0st),1.0,
30,TF Johnson (WI),1939-1939,1,2,1,1,0,0,1,1 (1ct 0st),0.5,
31,EC Joyce (IRE),2018-2018,1,2,1,1,0,0,1,1 (1ct 0st),0.5,
32,Kabir Khan (PAK),1994-1995,4,7,1,1,0,0,1,1 (1ct 0st),0.142,
33,S Randiv (SL),2010-2012,12,21,1,1,0,0,1,1 (1ct 0st),0.047,
34,AR Kapoor (INDIA),1994-1996,4,7,1,1,0,0,1,1 (1ct 0st),0.142,
35,SS Karim (INDIA),2000-2000,1,2,1,1,0,1,0,1 (1ct 0st),0.5,
36,C Karunaratne (SL),2019-2019,1,2,1,1,0,0,1,1 (1ct 0st),0.5,
37,TJD Kelly (AUS),1877-1879,2,4,1,1,0,0,1,1 (1ct 0st),0.25,
38,RB Kenny (INDIA),1958-1960,5,8,1,1,0,0,1,1 (1ct 0st),0.125,
39,ESM Kentish (WI),1948-1954,2,4,1,1,0,0,1,1 (1ct 0st),0.25,
40,RB Kerr (AUS),1985-1985,2,4,1,1,0,0,1,1 (1ct 0st),0.25,
41,I Khan (SA),2009-2009,1,2,1,1,0,0,1,1 (1ct 0st),0.5,
42,G Kishenchand (INDIA),1947-1952,5,5,1,1,0,0,1,1 (1ct 0st),0.2,
43,AE Knight (ENG),1904-1904,3,6,1,1,0,0,1,1 (1ct 0st),0.166,
44,DJ Knight (ENG),1921-1921,2,4,1,1,0,0,1,1 (1ct 0st),0.25,
45,CM Kuggeleijn (NZ),1988-1988,2,4,1,1,0,0,1,1 (1ct 0st),0.25,
46,HG Kuhn (SA),2017-2017,4,8,1,1,0,0,1,1 (1ct 0st),0.125,
47,AP Kuiper (SA),1992-1992,1,2,1,1,0,0,1,1 (1ct 0st),0.5,
48,NM Kulkarni (INDIA),1997-2001,3,3,1,1,0,0,1,1 (1ct 0st),0.33299999999999996,
49,RR Kulkarni (INDIA),1986-1987,3,6,1,1,0,0,1,1 (1ct 0st),0.166,
0,DSBP Kuruppu (SL),1987-1991,4,6,1,1,0,1,0,1 (1ct 0st),0.166,
1,MKGCP Lakshitha (SL),2002-2002,2,4,1,1,0,0,1,1 (1ct 0st),0.25,
2,Lall Singh (INDIA),1932-1932,1,2,1,1,0,0,1,1 (1ct 0st),0.5,
3,SG Law (AUS),1995-1995,1,2,1,1,0,0,1,1 (1ct 0st),0.5,
4,PK Lee (AUS),1931-1933,2,4,1,1,0,0,1,1 (1ct 0st),0.25,
5,GB Legge (ENG),1927-1930,5,8,1,1,0,0,1,1 (1ct 0st),0.125,
6,CFH Leslie (ENG),1882-1883,4,8,1,1,0,0,1,1 (1ct 0st),0.125,
7,HDG Leveson Gower (ENG),1910-1910,3,6,1,1,0,0,1,1 (1ct 0st),0.166,
8,SH Lewis (WI),2018-2018,2,2,1,1,0,0,1,1 (1ct 0st),0.5,
9,Liaqat Ali (PAK),1975-1978,5,7,1,1,0,0,1,1 (1ct 0st),0.142,
10,GFJ Liebenberg (SA),1998-1998,5,10,1,1,0,0,1,1 (1ct 0st),0.1,
11,James Lillywhite jnr (ENG),1877-1877,2,4,1,1,0,0,1,1 (1ct 0st),0.25,
12,NV Lindsay (SA),1921-1921,1,2,1,1,0,0,1,1 (1ct 0st),0.5,
13,WVS Ling (SA),1921-1923,6,12,1,1,0,0,1,1 (1ct 0st),0.083,
14,AF Lissette (NZ),1956-1956,2,2,1,1,0,0,1,1 (1ct 0st),0.5,
15,KS Lokuarachchi (SL),2003-2004,4,7,1,1,0,0,1,1 (1ct 0st),0.142,
16,AP Lucas (ENG),1879-1884,5,9,1,1,0,0,1,1 (1ct 0st),0.111,
17,MJ McCague (ENG),1993-1994,3,5,1,1,0,0,1,1 (1ct 0st),0.2,
18,CP McGahey (ENG),1902-1902,2,4,1,1,0,0,1,1 (1ct 0st),0.25,
19,J McIlwraith (AUS),1886-1886,1,1,1,1,0,0,1,1 (1ct 0st),1.0,
20,CJ McKay (AUS),2009-2009,1,2,1,1,0,0,1,1 (1ct 0st),0.5,
21,AH McKinnon (SA),1960-1967,8,16,1,1,0,0,1,1 (1ct 0st),0.062,
22,TN Madondo (ZIM),1998-2000,3,6,1,1,0,0,1,1 (1ct 0st),0.166,
23,NB Mahwire (ZIM),2002-2005,10,15,1,1,0,0,1,1 (1ct 0st),0.066,
24,A Maregwede (ZIM),2004-2004,2,2,1,1,0,0,1,1 (1ct 0st),0.5,
25,CS Marriott (ENG),1933-1933,1,2,1,1,0,0,1,1 (1ct 0st),0.5,
26,HJH Marshall (NZ),2000-2006,13,23,1,1,0,0,1,1 (1ct 0st),0.043,
27,RE Marshall (WI),1951-1952,4,8,1,1,0,0,1,1 (1ct 0st),0.125,
28,T Maruma (ZIM),2013-2013,1,2,1,1,0,0,1,1 (1ct 0st),0.5,
29,WP Masakadza (ZIM),2018-2018,1,2,1,1,0,0,1,1 (1ct 0st),0.5,
30,RAL Massie (AUS),1972-1973,6,12,1,1,0,0,1,1 (1ct 0st),0.083,
31,ADG Matthews (ENG),1937-1937,1,2,1,1,0,0,1,1 (1ct 0st),0.5,
32,CD Matthews (AUS),1986-1988,3,6,1,1,0,0,1,1 (1ct 0st),0.166,
33,W Mead (ENG),1899-1899,1,2,1,1,0,0,1,1 (1ct 0st),0.5,
34,KR Meherhomji (INDIA),1936-1936,1,1,1,1,0,1,0,1 (1ct 0st),1.0,
35,VL Mehra (INDIA),1955-1964,8,16,1,1,0,0,1,1 (1ct 0st),0.062,
36,CA Merry (WI),1933-1933,2,2,1,1,0,0,1,1 (1ct 0st),0.5,
37,KD Meuleman (AUS),1946-1946,1,2,1,1,0,0,1,1 (1ct 0st),0.5,
38,PL Mhambrey (INDIA),1996-1996,2,4,1,1,0,0,1,1 (1ct 0st),0.25,
39,J Middleton (SA),1896-1902,6,11,1,1,0,0,1,1 (1ct 0st),0.09,
40,LSM Miller (NZ),1953-1958,13,20,1,1,0,0,1,1 (1ct 0st),0.05,
41,FW Milligan (ENG),1899-1899,2,4,1,1,0,0,1,1 (1ct 0st),0.25,
42,CH Mills (SA),1892-1892,1,1,1,1,0,0,1,1 (1ct 0st),1.0,
43,JE Mills (NZ),1930-1933,7,10,1,1,0,0,1,1 (1ct 0st),0.1,
44,TB Mitchell (ENG),1933-1935,5,9,1,1,0,0,1,1 (1ct 0st),0.111,
45,Mohammad Ayub (PAK),2012-2012,1,2,1,1,0,0,1,1 (1ct 0st),0.5,
46,Mohammad Farooq (PAK),1960-1965,7,11,1,1,0,0,1,1 (1ct 0st),0.09,
47,Mohammad Hussain (PAK),1996-1998,2,3,1,1,0,0,1,1 (1ct 0st),0.33299999999999996,
48,Mohammad Ramzan (PAK),1997-1997,1,1,1,1,0,0,1,1 (1ct 0st),1.0,
49,Mohammad Talha (PAK),2009-2014,4,6,1,1,0,0,1,1 (1ct 0st),0.166,
0,D Mohammed (WI),2004-2006,5,10,1,1,0,0,1,1 (1ct 0st),0.1,
1,AW Mold (ENG),1893-1893,3,5,1,1,0,0,1,1 (1ct 0st),0.2,
2,BD Morrison (NZ),1963-1963,1,1,1,1,0,0,1,1 (1ct 0st),1.0,
3,EA Moseley (WI),1990-1990,2,4,1,1,0,0,1,1 (1ct 0st),0.25,
4,H Moses (AUS),1887-1895,6,12,1,1,0,0,1,1 (1ct 0st),0.083,
5,AE Moss (ENG),1954-1960,9,17,1,1,0,0,1,1 (1ct 0st),0.057999999999999996,
6,WH Moule (AUS),1880-1880,1,2,1,1,0,0,1,1 (1ct 0st),0.5,
7,Mufasir-ul-Haq (PAK),1965-1965,1,2,1,1,0,0,1,1 (1ct 0st),0.5,
8,CT Mumba (ZIM),2016-2016,2,4,1,1,0,0,1,1 (1ct 0st),0.25,
9,Munir Malik (PAK),1959-1962,3,4,1,1,0,0,1,1 (1ct 0st),0.25,
10,Mustafizur Rahman (BDESH),2015-2019,13,21,1,1,0,0,1,1 (1ct 0st),0.047,
11,S Nadeem (INDIA),2019-2019,1,2,1,1,0,0,1,1 (1ct 0st),0.5,
12,Nasir Jamshed (PAK),2013-2013,2,4,1,1,0,0,1,1 (1ct 0st),0.25,
13,JG Navle (INDIA),1932-1933,2,4,1,1,0,1,0,1 (1ct 0st),0.25,
14,SV Nayak (INDIA),1982-1982,2,3,1,1,0,0,1,1 (1ct 0st),0.33299999999999996,
15,Nayeem Hasan (BDESH),2018-2019,4,7,1,1,0,0,1,1 (1ct 0st),0.142,
16,Nazimuddin (BDESH),2011-2012,3,5,1,1,0,0,1,1 (1ct 0st),0.2,
17,N Ncube (ZIM),2011-2011,1,2,1,1,0,0,1,1 (1ct 0st),0.5,
18,JD Nel (SA),1949-1957,6,10,1,1,0,0,1,1 (1ct 0st),0.1,
19,PJ Newport (ENG),1988-1991,3,6,1,1,0,0,1,1 (1ct 0st),0.166,
20,M Ngam (SA),2000-2001,3,5,1,1,0,0,1,1 (1ct 0st),0.2,
21,Niaz Ahmed (PAK),1967-1969,2,4,1,1,0,0,1,1 (1ct 0st),0.25,
22,G Noblet (AUS),1950-1953,3,6,1,1,0,0,1,1 (1ct 0st),0.166,
23,AL Ochse (SA),1928-1929,3,6,1,1,0,0,1,1 (1ct 0st),0.166,
24,JL Ontong (SA),2002-2004,2,4,1,1,0,0,1,1 (1ct 0st),0.25,
25,C Overton (ENG),2017-2019,4,6,1,1,0,0,1,1 (1ct 0st),0.166,
26,GWF Overton (NZ),1953-1954,3,5,1,1,0,0,1,1 (1ct 0st),0.2,
27,AW Palm (SA),1927-1928,1,2,1,1,0,0,1,1 (1ct 0st),0.5,
28,BA Parchment (WI),2008-2008,2,3,1,1,0,0,1,1 (1ct 0st),0.33299999999999996,
29,GAHM Parkar (INDIA),1982-1982,1,2,1,1,0,0,1,1 (1ct 0st),0.5,
30,DC Parkin (SA),1892-1892,1,1,1,1,0,0,1,1 (1ct 0st),1.0,
31,NT Pascal (WI),2010-2010,2,2,1,1,0,0,1,1 (1ct 0st),0.5,
32,RGM Patel (INDIA),1988-1988,1,2,1,1,0,0,1,1 (1ct 0st),0.5,
33,SR Patil (INDIA),1955-1955,1,2,1,1,0,0,1,1 (1ct 0st),0.5,
34,SG Peall (ZIM),1993-1994,4,7,1,1,0,0,1,1 (1ct 0st),0.142,
35,COC Pearse (SA),1910-1911,3,5,1,1,0,0,1,1 (1ct 0st),0.2,
36,ASA Perera (SL),1998-2001,3,6,1,1,0,0,1,1 (1ct 0st),0.166,
37,NLTC Perera (SL),2011-2012,6,9,1,1,0,0,1,1 (1ct 0st),0.111,
38,RTD Perks (ENG),1939-1939,2,3,1,1,0,0,1,1 (1ct 0st),0.33299999999999996,
39,NO Perry (WI),1999-1999,4,7,1,1,0,0,1,1 (1ct 0st),0.142,
40,OJ Phillips (WI),2009-2009,2,4,1,1,0,0,1,1 (1ct 0st),0.25,
41,CJ Poole (ENG),1951-1952,3,5,1,1,0,0,1,1 (1ct 0st),0.2,
42,MB Poore (NZ),1953-1956,14,20,1,1,0,0,1,1 (1ct 0st),0.05,
43,RL Powell (WI),1999-2004,2,4,1,1,0,0,1,1 (1ct 0st),0.25,
44,D Pretorius (SA),2019-2019,1,2,1,1,0,0,1,1 (1ct 0st),0.5,
45,N Puna (NZ),1966-1966,3,5,1,1,0,0,1,1 (1ct 0st),0.2,
46,NA Quinn (SA),1929-1932,12,19,1,1,0,0,1,1 (1ct 0st),0.052000000000000005,
47,LS Rajput (INDIA),1985-1985,2,4,1,1,0,0,1,1 (1ct 0st),0.25,
48,L Ramji (INDIA),1933-1933,1,2,1,1,0,0,1,1 (1ct 0st),0.5,
49,KM Rangnekar (INDIA),1947-1948,3,4,1,1,0,0,1,1 (1ct 0st),0.25,
0,VB Ranjane (INDIA),1958-1964,7,14,1,1,0,0,1,1 (1ct 0st),0.071,
1,Ranjan Das (BDESH),2000-2000,1,2,1,1,0,0,1,1 (1ct 0st),0.5,
2,JR Ratnayeke (SL),1982-1989,22,32,1,1,0,0,1,1 (1ct 0st),0.031,
3,JC Reedman (AUS),1894-1894,1,2,1,1,0,0,1,1 (1ct 0st),0.5,
4,DA Reeve (ENG),1992-1992,3,6,1,1,0,0,1,1 (1ct 0st),0.166,
5,MR Rege (INDIA),1949-1949,1,1,1,1,0,0,1,1 (1ct 0st),1.0,
6,SF Rehman (PAK),1958-1958,1,2,1,1,0,0,1,1 (1ct 0st),0.5,
7,JA Rennie (ZIM),1993-1997,4,8,1,1,0,0,1,1 (1ct 0st),0.125,
8,AJ Richardson (AUS),1924-1926,9,14,1,1,0,0,1,1 (1ct 0st),0.071,
9,DW Richardson (ENG),1957-1957,1,2,1,1,0,0,1,1 (1ct 0st),0.5,
10,GR Robertson (AUS),1998-1998,4,7,1,1,0,0,1,1 (1ct 0st),0.142,
11,RH Robinson (AUS),1936-1936,1,2,1,1,0,0,1,1 (1ct 0st),0.5,
12,BG Rogers (ZIM),2005-2005,4,6,1,1,0,0,1,1 (1ct 0st),0.166,
13,CF Root (ENG),1926-1926,3,3,1,1,0,0,1,1 (1ct 0st),0.33299999999999996,
14,GF Rorke (AUS),1959-1959,4,8,1,1,0,0,1,1 (1ct 0st),0.125,
15,CG Rowe (NZ),1946-1946,1,1,1,1,0,0,1,1 (1ct 0st),1.0,
16,JJ Roy (ENG),2019-2019,5,10,1,1,0,0,1,1 (1ct 0st),0.1,
17,P Roy (INDIA),1982-1982,2,2,1,1,0,0,1,1 (1ct 0st),0.5,
18,AD Russell (WI),2010-2010,1,2,1,1,0,0,1,1 (1ct 0st),0.5,
19,MJ Saggers (ENG),2003-2004,3,6,1,1,0,0,1,1 (1ct 0st),0.166,
20,SV Samuelson (SA),1910-1910,1,2,1,1,0,0,1,1 (1ct 0st),0.5,
21,BS Sandhu (INDIA),1983-1983,8,11,1,1,0,0,1,1 (1ct 0st),0.09,
22,Sanwar Hossain (BDESH),2001-2003,9,11,1,1,0,0,1,1 (1ct 0st),0.09,
23,Sarandeep Singh (INDIA),2000-2002,3,5,1,1,0,0,1,1 (1ct 0st),0.2,
24,CJ Sayers (AUS),2018-2018,1,2,1,1,0,0,1,1 (1ct 0st),0.5,
25,AW Seccull (SA),1896-1896,1,1,1,1,0,0,1,1 (1ct 0st),1.0,
26,J Selby (ENG),1877-1882,6,11,1,1,0,1,0,1 (1ct 0st),0.09,
27,RHD Sellers (AUS),1964-1964,1,1,1,1,0,0,1,1 (1ct 0st),1.0,
28,MWW Selvey (ENG),1976-1977,3,6,1,1,0,0,1,1 (1ct 0st),0.166,
29,SMSM Senanayake (SL),2013-2014,1,2,1,1,0,0,1,1 (1ct 0st),0.5,
30,D Shackleton (ENG),1950-1963,7,13,1,1,0,0,1,1 (1ct 0st),0.076,
31,Shadab Khan (PAK),2017-2019,5,9,1,1,0,0,1,1 (1ct 0st),0.111,
32,Shahriar Hossain (BDESH),2000-2004,3,5,1,0,1,0,0,1 (0ct 1st),0.2,
33,Shakeel Ahmed snr (PAK),1998-1998,1,2,1,1,0,0,1,1 (1ct 0st),0.5,
34,MD Shanaka (SL),2016-2017,3,4,1,1,0,0,1,1 (1ct 0st),0.25,
35,AK Sharma (INDIA),1988-1988,1,2,1,1,0,0,1,1 (1ct 0st),0.5,
36,PH Sharma (INDIA),1974-1977,5,7,1,1,0,0,1,1 (1ct 0st),0.142,
37,SK Sharma (INDIA),1988-1990,2,4,1,1,0,0,1,1 (1ct 0st),0.25,
38,J Sharp (ENG),1909-1909,3,6,1,1,0,0,1,1 (1ct 0st),0.166,
39,IT Shillingford (WI),1977-1978,4,8,1,1,0,0,1,1 (1ct 0st),0.125,
40,RH Shodhan (INDIA),1952-1953,3,6,1,1,0,0,1,1 (1ct 0st),0.166,
41,K Shuttleworth (ENG),1970-1971,5,9,1,1,0,0,1,1 (1ct 0st),0.111,
42,IR Siddiqui (INDIA),2001-2001,1,2,1,1,0,0,1,1 (1ct 0st),0.5,
43,KJ Silva (SL),1995-1998,7,12,1,1,0,0,1,1 (1ct 0st),0.083,
44,GHT Simpson-Hayward (ENG),1910-1910,5,10,1,1,0,0,1,1 (1ct 0st),0.1,
45,IM Sinclair (NZ),1956-1956,2,3,1,1,0,0,1,1 (1ct 0st),0.33299999999999996,
46,R Singh (INDIA),1999-1999,1,2,1,1,0,0,1,1 (1ct 0st),0.5,
47,VRV Singh (INDIA),2006-2007,5,10,1,1,0,0,1,1 (1ct 0st),0.1,
48,CIJ Smith (ENG),1935-1937,5,9,1,1,0,0,1,1 (1ct 0st),0.111,
49,D Smith (ENG),1935-1935,2,4,1,1,0,0,1,1 (1ct 0st),0.25,
0,FB Smith (NZ),1947-1952,4,7,1,1,0,0,1,1 (1ct 0st),0.142,
1,H Smith (ENG),1928-1928,1,2,1,1,0,1,0,1 (1ct 0st),0.5,
2,SB Smith (AUS),1984-1984,3,6,1,1,0,0,1,1 (1ct 0st),0.166,
3,TPB Smith (ENG),1946-1947,4,5,1,1,0,0,1,1 (1ct 0st),0.2,
4,RP Snell (SA),1992-1994,5,9,1,1,0,0,1,1 (1ct 0st),0.111,
5,WRT Solomon (SA),1899-1899,1,2,1,1,0,0,1,1 (1ct 0st),0.5,
6,WH St Hill (WI),1928-1930,3,4,1,1,0,0,1,1 (1ct 0st),0.25,
7,DA Stirling (NZ),1984-1986,6,11,1,1,0,0,1,1 (1ct 0st),0.09,
8,MD Stoneman (ENG),2017-2018,11,19,1,1,0,0,1,1 (1ct 0st),0.052000000000000005,
9,GB Street (ENG),1923-1923,1,1,1,0,1,0,0,1 (0ct 1st),1.0,
10,PC Strydom (SA),2000-2000,2,4,1,1,0,0,1,1 (1ct 0st),0.25,
11,MJ Susskind (SA),1924-1924,5,5,1,1,0,0,1,1 (1ct 0st),0.2,
12,SW Tait (AUS),2005-2008,3,6,1,1,0,0,1,1 (1ct 0st),0.166,
13,Talha Jubair (BDESH),2002-2004,7,9,1,1,0,0,1,1 (1ct 0st),0.111,
14,Tanvir Ahmed (PAK),2010-2013,5,10,1,1,0,0,1,1 (1ct 0st),0.1,
15,GL Tapscott (SA),1913-1913,1,1,1,1,0,0,1,1 (1ct 0st),1.0,
16,Tareq Aziz (BDESH),2004-2004,3,4,1,1,0,0,1,1 (1ct 0st),0.25,
17,Taskin Ahmed (BDESH),2017-2017,5,10,1,1,0,0,1,1 (1ct 0st),0.1,
18,K Taylor (ENG),1959-1964,3,6,1,1,0,0,1,1 (1ct 0st),0.166,
19,LB Taylor (ENG),1985-1985,2,4,1,1,0,0,1,1 (1ct 0st),0.25,
20,G Thornton (SA),1902-1902,1,2,1,1,0,0,1,1 (1ct 0st),0.5,
21,DCH Townsend (ENG),1935-1935,3,5,1,1,0,0,1,1 (1ct 0st),0.2,
22,JPF Travers (AUS),1902-1902,1,2,1,1,0,0,1,1 (1ct 0st),0.5,
23,PB Truscott (NZ),1965-1965,1,2,1,1,0,0,1,1 (1ct 0st),0.5,
24,LL Tsotsobe (SA),2010-2011,5,9,1,1,0,0,1,1 (1ct 0st),0.111,
25,NC Tufnell (ENG),1910-1910,1,2,1,0,1,0,0,1 (0ct 1st),0.5,
26,MJL Turnbull (ENG),1930-1936,9,17,1,1,0,0,1,1 (1ct 0st),0.057999999999999996,
27,Tushar Imran (BDESH),2002-2007,5,6,1,1,0,0,1,1 (1ct 0st),0.166,
28,RK Tyldesley (ENG),1924-1930,7,11,1,1,0,0,1,1 (1ct 0st),0.09,
29,SD Udal (ENG),2005-2006,4,7,1,1,0,0,1,1 (1ct 0st),0.142,
30,Umar Amin (PAK),2010-2010,4,8,1,1,0,0,1,1 (1ct 0st),0.125,
31,PGV van der Bijl (SA),1938-1939,5,8,1,1,0,0,1,1 (1ct 0st),0.125,
32,HE van der Dussen (SA),2019-2019,1,2,1,1,0,0,1,1 (1ct 0st),0.5,
33,M Venkataramana (INDIA),1989-1989,1,2,1,1,0,0,1,1 (1ct 0st),0.5,
34,GH Vihari (INDIA),2018-2019,7,14,1,1,0,0,1,1 (1ct 0st),0.071,
35,DP Viljoen (ZIM),1998-2000,2,3,1,1,0,0,1,1 (1ct 0st),0.33299999999999996,
36,CH Vintcent (SA),1889-1892,3,4,1,1,0,0,1,1 (1ct 0st),0.25,
37,Vizianagram (INDIA),1936-1936,3,5,1,1,0,0,1,1 (1ct 0st),0.2,
38,A Waddington (ENG),1920-1921,2,4,1,1,0,0,1,1 (1ct 0st),0.25,
39,MG Waite (AUS),1938-1938,2,3,1,1,0,0,1,1 (1ct 0st),0.33299999999999996,
40,AC Waller (ZIM),1996-1996,2,4,1,1,0,0,1,1 (1ct 0st),0.25,
41,A Ward (ENG),1893-1895,7,13,1,1,0,0,1,1 (1ct 0st),0.076,
42,FA Ward (AUS),1936-1938,4,6,1,1,0,0,1,1 (1ct 0st),0.166,
43,IJ Ward (ENG),2001-2001,5,9,1,1,0,0,1,1 (1ct 0st),0.111,
44,A Warren (ENG),1905-1905,1,2,1,1,0,0,1,1 (1ct 0st),0.5,
45,AS Wassan (INDIA),1990-1990,4,7,1,1,0,0,1,1 (1ct 0st),0.142,
46,SL Watkin (ENG),1991-1993,3,6,1,1,0,0,1,1 (1ct 0st),0.166,
47,JR Watkins (AUS),1973-1973,1,2,1,1,0,0,1,1 (1ct 0st),0.5,
48,M Watkinson (ENG),1995-1996,4,7,1,1,0,0,1,1 (1ct 0st),0.142,
49,CD Watson (WI),1960-1962,7,14,1,1,0,0,1,1 (1ct 0st),0.071,
0,GD Watson (AUS),1966-1972,5,9,1,1,0,0,1,1 (1ct 0st),0.111,
1,S Wazir Ali (INDIA),1932-1936,7,13,1,1,0,0,1,1 (1ct 0st),0.076,
2,C Wesley (SA),1960-1960,3,5,1,1,0,0,1,1 (1ct 0st),0.2,
3,T Westley (ENG),2017-2017,5,10,1,1,0,0,1,1 (1ct 0st),0.1,
4,JJ Whitaker (ENG),1986-1986,1,2,1,1,0,0,1,1 (1ct 0st),0.5,
5,AW White (WI),1965-1965,2,3,1,1,0,0,1,1 (1ct 0st),0.33299999999999996,
6,CL White (AUS),2008-2008,4,8,1,1,0,0,1,1 (1ct 0st),0.125,
7,RGCE Wijesuriya (SL),1982-1985,4,6,1,1,0,0,1,1 (1ct 0st),0.166,
8,D Wilson (ENG),1964-1971,6,12,1,1,0,0,1,1 (1ct 0st),0.083,
9,PL Winslow (SA),1950-1955,5,8,1,1,0,0,1,1 (1ct 0st),0.125,
10,AJ Woodcock (AUS),1974-1974,1,2,1,1,0,0,1,1 (1ct 0st),0.5,
11,J Yadav (INDIA),2016-2017,4,8,1,1,0,0,1,1 (1ct 0st),0.125,
12,T Yohannan (INDIA),2001-2002,3,6,1,1,0,0,1,1 (1ct 0st),0.166,
13,HI Young (ENG),1899-1899,2,4,1,1,0,0,1,1 (1ct 0st),0.25,
14,Zahoor Elahi (PAK),1996-1996,2,4,1,1,0,0,1,1 (1ct 0st),0.25,
15,Zakir Khan (PAK),1986-1989,2,4,1,1,0,0,1,1 (1ct 0st),0.25,
16,M Zondeki (SA),2003-2008,6,11,1,1,0,0,1,1 (1ct 0st),0.09,
17,Abdur Rauf (PAK),2009-2009,3,6,0,0,0,0,0,0,0.0,
18,Abid Ali (PAK),2019-2019,2,3,0,0,0,0,0,0,0.0,
19,CA Absolom (ENG),1879-1879,1,2,0,0,0,0,0,0,0.0,
20,Aftab Baloch (PAK),1969-1975,2,4,0,0,0,0,0,0,0.0,
21,U Afzaal (ENG),2001-2001,3,4,0,0,0,0,0,0,0.0,
22,AC Agar (AUS),2013-2017,4,8,0,0,0,0,0,0,0.0,
23,Agha Zahid (PAK),1975-1975,1,2,0,0,0,0,0,0,0.0,
24,JP Agnew (ENG),1984-1985,3,6,0,0,0,0,0,0,0.0,
25,Alamgir Kabir (BDESH),2002-2004,3,4,0,0,0,0,0,0,0.0,
26,HH Alexander (AUS),1933-1933,1,2,0,0,0,0,0,0,0.0,
27,Imtiaz Ali (WI),1976-1976,1,2,0,0,0,0,0,0,0.0,
28,Kabir Ali (ENG),2003-2003,1,2,0,0,0,0,0,0,0.0,
29,Ali Hussain Rizvi (PAK),1997-1997,1,1,0,0,0,0,0,0,0.0,
30,FE Allan (AUS),1879-1879,1,2,0,0,0,0,0,0,0.0,
31,PJ Allan (AUS),1965-1965,1,2,0,0,0,0,0,0,0.0,
32,MJC Allom (ENG),1930-1931,5,8,0,0,0,0,0,0,0.0,
33,Al-Amin Hossain (BDESH),2013-2019,7,11,0,0,0,0,0,0,0.0,
34,MKDI Amerasinghe (SL),2008-2008,1,2,0,0,0,0,0,0,0.0,
35,Amir Elahi (INDIA/PAK),1947-1952,6,9,0,0,0,0,0,0,0.0,
36,Amir Hamza (AFG),2019-2019,1,2,0,0,0,0,0,0,0.0,
37,SA Ankola (INDIA),1989-1989,1,2,0,0,0,0,0,0,0.0,
38,Anwar Hossain Monir (BDESH),2003-2005,3,3,0,0,0,0,0,0,0.0,
39,Anwar Hossain (BDESH),2002-2002,1,1,0,0,0,0,0,0,0.0,
40,Anwar Hussain (PAK),1952-1952,4,6,0,0,0,0,0,0,0.0,
41,Anwar Khan (PAK),1979-1979,1,2,0,0,0,0,0,0,0.0,
42,AL Apte (INDIA),1959-1959,1,1,0,0,0,0,0,0,0.0,
43,AG Archer (ENG),1899-1899,1,2,0,0,0,0,0,0,0.0,
44,KA Archer (AUS),1950-1951,5,10,0,0,0,0,0,0,0.0,
45,Arif Butt (PAK),1964-1965,3,6,0,0,0,0,0,0,0.0,
46,T Armitage (ENG),1877-1877,2,4,0,0,0,0,0,0,0.0,
47,J Arnold (ENG),1931-1931,1,2,0,0,0,0,0,0,0.0,
48,Arshad Khan (PAK),1997-2005,9,17,0,0,0,0,0,0,0.0,
49,NS Asgarali (WI),1957-1957,2,2,0,0,0,0,0,0,0.0,
0,Ashfaq Ahmed (PAK),1993-1993,1,2,0,0,0,0,0,0,0.0,
1,WH Ashley (SA),1889-1889,1,1,0,0,0,0,0,0,0.0,
2,Atif Rauf (PAK),1994-1994,1,2,0,0,0,0,0,0,0.0,
3,Azam Khan (PAK),1996-1996,1,2,0,0,0,0,0,0,0.0,
4,Azhar Khan (PAK),1980-1980,1,2,0,0,0,0,0,0,0.0,
5,Azmat Rana (PAK),1980-1980,1,2,0,0,0,0,0,0,0.0,
6,RJ Bailey (ENG),1988-1990,4,7,0,0,0,0,0,0,0.0,
7,MRCN Bandaratilleke (SL),1998-2001,7,14,0,0,0,0,0,0,0.0,
8,SN Banerjee (INDIA),1949-1949,1,2,0,0,0,0,0,0,0.0,
9,ST Banerjee (INDIA),1992-1992,1,2,0,0,0,0,0,0,0.0,
10,C Bannerman (AUS),1877-1879,3,6,0,0,0,0,0,0,0.0,
11,M Baqa Jilani (INDIA),1936-1936,1,2,0,0,0,0,0,0,0.0,
12,GD Barlow (ENG),1976-1977,3,6,0,0,0,0,0,0,0.0,
13,AG Barrett (WI),1971-1975,6,10,0,0,0,0,0,0,0.0,
14,VA Barton (ENG),1892-1892,1,2,0,0,0,0,0,0,0.0,
15,GR Beard (AUS),1980-1980,3,4,0,0,0,0,0,0,0.0,
16,JEF Beck (NZ),1953-1956,8,14,0,0,0,0,0,0,0.0,
17,J Benaud (AUS),1972-1973,3,6,0,0,0,0,0,0,0.0,
18,JE Benjamin (ENG),1994-1994,1,2,0,0,0,0,0,0,0.0,
19,HK Bennett (NZ),2010-2010,1,2,0,0,0,0,0,0,0.0,
20,MR Benson (ENG),1986-1986,1,2,0,0,0,0,0,0,0.0,
21,DE Bernard (WI),2003-2009,3,6,0,0,0,0,0,0,0.0,
22,BJ Bess (WI),2010-2010,1,2,0,0,0,0,0,0,0.0,
23,N Betancourt (WI),1930-1930,1,2,0,0,0,0,0,0,0.0,
24,AR Bhat (INDIA),1983-1983,2,3,0,0,0,0,0,0,0.0,
25,Bilawal Bhatti (PAK),2013-2014,2,4,0,0,0,0,0,0,0.0,
26,GF Bissett (SA),1927-1928,4,8,0,0,0,0,0,0,0.0,
27,MI Black (WI),2000-2002,6,10,0,0,0,0,0,0,0.0,
28,ID Blackwell (ENG),2006-2006,1,2,0,0,0,0,0,0,0.0,
29,EG Bock (SA),1935-1935,1,2,0,0,0,0,0,0,0.0,
30,GE Bond (SA),1938-1938,1,2,0,0,0,0,0,0,0.0,
31,MW Booth (ENG),1913-1914,2,4,0,0,0,0,0,0,0.0,
32,T Bosch (SA),1992-1992,1,2,0,0,0,0,0,0,0.0,
33,WM Bradley (ENG),1899-1899,2,4,0,0,0,0,0,0,0.0,
34,CR Brathwaite (WI),2015-2016,3,4,0,0,0,0,0,0,0.0,
35,W Brearley (ENG),1905-1912,4,8,0,0,0,0,0,0,0.0,
36,GA Briant (ZIM),1993-1993,1,1,0,0,0,0,0,0,0.0,
37,NT Broom (NZ),2017-2017,2,4,0,0,0,0,0,0,0.0,
38,LS Brown (SA),1931-1932,2,3,0,0,0,0,0,0,0.0,
39,GK Bruk-Jackson (ZIM),1993-1993,2,4,0,0,0,0,0,0,0.0,
40,C Burke (NZ),1946-1946,1,1,0,0,0,0,0,0,0.0,
41,SF Burke (SA),1962-1965,2,4,0,0,0,0,0,0,0.0,
42,EJK Burn (AUS),1890-1890,2,4,0,0,0,0,0,0,0.0,
43,AR Butcher (ENG),1979-1979,1,2,0,0,0,0,0,0,0.0,
44,LS Butler (WI),1955-1955,1,1,0,0,0,0,0,0,0.0,
45,LA Butterfield (NZ),1946-1946,1,1,0,0,0,0,0,0,0.0,
46,ID Buys (SA),1922-1922,1,2,0,0,0,0,0,0,0.0,
47,ST Callaway (AUS),1892-1895,3,6,0,0,0,0,0,0,0.0,
48,FJ Cameron (WI),1948-1949,5,10,0,0,0,0,0,0,0.0,
49,JH Cameron (WI),1939-1939,2,4,0,0,0,0,0,0,0.0,
0,DB Carr (ENG),1951-1952,2,2,0,0,0,0,0,0,0.0,
1,DW Carr (ENG),1909-1909,1,2,0,0,0,0,0,0,0.0,
2,HWR Cartwright (AUS),2017-2017,2,4,0,0,0,0,0,0,0.0,
3,G Challenor (WI),1928-1928,3,3,0,0,0,0,0,0,0.0,
4,HS Chang (WI),1979-1979,1,2,0,0,0,0,0,0,0.0,
5,PC Charlton (AUS),1890-1890,2,4,0,0,0,0,0,0,0.0,
6,HRJ Charlwood (ENG),1877-1877,2,4,0,0,0,0,0,0,0.0,
7,TL Chatara (ZIM),2013-2018,9,17,0,0,0,0,0,0,0.0,
8,W Chatterton (ENG),1892-1892,1,2,0,0,0,0,0,0,0.0,
9,CJ Chibhabha (ZIM),2016-2017,3,4,0,0,0,0,0,0,0.0,
10,MT Chinouya (ZIM),2016-2016,2,3,0,0,0,0,0,0,0.0,
11,TS Chisoro (ZIM),2017-2017,1,1,0,0,0,0,0,0,0.0,
12,N Chopra (INDIA),2000-2000,1,1,0,0,0,0,0,0,0.0,
13,NR Chowdhury (INDIA),1949-1951,2,3,0,0,0,0,0,0,0.0,
14,S Christopherson (ENG),1884-1884,1,2,0,0,0,0,0,0,0.0,
15,GWA Chubb (SA),1951-1951,5,9,0,0,0,0,0,0,0.0,
16,EW Clark (ENG),1929-1934,8,15,0,0,0,0,0,0,0.0,
17,CB Clarke (WI),1939-1939,3,6,0,0,0,0,0,0,0.0,
18,DC Cleverley (NZ),1932-1946,2,2,0,0,0,0,0,0,0.0,
19,JAK Cochran (SA),1931-1931,1,2,0,0,0,0,0,0,0.0,
20,A Coningham (AUS),1894-1895,1,2,0,0,0,0,0,0,0.0,
21,C Cook (ENG),1947-1947,1,2,0,0,0,0,0,0,0.0,
22,FJ Cook (SA),1896-1896,1,2,0,0,0,0,0,0,0.0,
23,SH Cook (AUS),1997-1997,2,4,0,0,0,0,0,0,0.0,
24,SJ Cook (SA),1992-1993,3,5,0,0,0,0,0,0,0.0,
25,GE Corling (AUS),1964-1964,5,8,0,0,0,0,0,0,0.0,
26,SS Cottrell (WI),2013-2014,2,2,0,0,0,0,0,0,0.0,
27,G Coulthard (AUS),1882-1882,1,2,0,0,0,0,0,0,0.0,
28,Hon.CJ Coventry (ENG),1889-1889,2,4,0,0,0,0,0,0,0.0,
29,A Coxon (ENG),1948-1948,1,2,0,0,0,0,0,0,0.0,
30,MS Crane (ENG),2018-2018,1,1,0,0,0,0,0,0,0.0,
31,Z Crawley (ENG),2019-2019,1,2,0,0,0,0,0,0,0.0,
32,GF Cresswell (NZ),1949-1951,3,4,0,0,0,0,0,0,0.0,
33,G Cripps (SA),1892-1892,1,1,0,0,0,0,0,0,0.0,
34,GJ Crocker (ZIM),1992-1992,3,5,0,0,0,0,0,0,0.0,
35,DJ Cullen (AUS),2006-2006,1,2,0,0,0,0,0,0,0.0,
36,TK Curran (ENG),2017-2018,2,3,0,0,0,0,0,0,0.0,
37,AC Dale (AUS),1998-1999,2,4,0,0,0,0,0,0,0.0,
38,JW D'Arcy (NZ),1958-1958,5,6,0,0,0,0,0,0,0.0,
39,EQ Davies (SA),1936-1939,5,6,0,0,0,0,0,0,0.0,
40,SP Davis (AUS),1986-1986,1,1,0,0,0,0,0,0,0.0,
41,AC Dawson (SA),2003-2003,2,4,0,0,0,0,0,0,0.0,
42,EW Dawson (ENG),1928-1930,5,8,0,0,0,0,0,0,0.0,
43,Z de Bruyn (SA),2004-2004,3,5,0,0,0,0,0,0,0.0,
44,RP de Groen (NZ),1993-1994,5,7,0,0,0,0,0,0,0.0,
45,AR Dell (AUS),1971-1974,2,4,0,0,0,0,0,0,0.0,
46,GRA de Silva (SL),1982-1982,4,8,0,0,0,0,0,0,0.0,
47,DT Dewdney (WI),1955-1958,9,16,0,0,0,0,0,0,0.0,
48,JG Dewes (ENG),1948-1950,5,8,0,0,0,0,0,0,0.0,
49,AE Dipper (ENG),1921-1921,1,2,0,0,0,0,0,0,0.0,
0,GH Dockrell (IRE),2019-2019,1,2,0,0,0,0,0,0,0.0,
1,RG Draper (SA),1950-1950,2,3,0,0,0,0,0,0,0.0,
2,JRF Duncan (AUS),1971-1971,1,2,0,0,0,0,0,0,0.0,
3,FJ Durston (ENG),1921-1921,1,2,0,0,0,0,0,0,0.0,
4,DV Dyer (SA),1947-1947,3,6,0,0,0,0,0,0,0.0,
5,KH Eastwood (AUS),1971-1971,1,2,0,0,0,0,0,0,0.0,
6,HI Ebeling (AUS),1934-1934,1,2,0,0,0,0,0,0,0.0,
7,RM Edwards (WI),1968-1969,5,9,0,0,0,0,0,0,0.0,
8,WJ Edwards (AUS),1974-1974,3,6,0,0,0,0,0,0,0.0,
9,Ehsanul Haque (BDESH),2002-2002,1,1,0,0,0,0,0,0,0.0,
10,Ehsan Adil (PAK),2013-2015,3,5,0,0,0,0,0,0,0.0,
11,RWG Emery (NZ),1952-1952,2,3,0,0,0,0,0,0,0.0,
12,GM Emmett (ENG),1948-1948,1,2,0,0,0,0,0,0,0.0,
13,AJ Evans (ENG),1921-1921,1,2,0,0,0,0,0,0,0.0,
14,Faheem Ashraf (PAK),2018-2019,4,7,0,0,0,0,0,0,0.0,
15,Faisal Hossain (BDESH),2004-2004,1,2,0,0,0,0,0,0,0.0,
16,Farhan Adil (PAK),2003-2003,1,2,0,0,0,0,0,0,0.0,
17,Farooq Hamid (PAK),1964-1964,1,2,0,0,0,0,0,0,0.0,
18,Farrukh Zaman (PAK),1976-1976,1,2,0,0,0,0,0,0,0.0,
19,JP Faulkner (AUS),2013-2013,1,2,0,0,0,0,0,0,0.0,
20,CJ Ferguson (AUS),2016-2016,1,1,0,0,0,0,0,0,0.0,
21,LH Ferguson (NZ),2019-2019,1,2,0,0,0,0,0,0,0.0,
22,MP Fernandes (WI),1928-1930,2,3,0,0,0,0,0,0,0.0,
23,ERNS Fernando (SL),1983-1984,5,8,0,0,0,0,0,0,0.0,
24,KADM Fernando (SL),2003-2003,2,4,0,0,0,0,0,0,0.0,
25,NR Ferreira (ZIM),2005-2005,1,1,0,0,0,0,0,0,0.0,
26,CE Finlason (SA),1889-1889,1,2,0,0,0,0,0,0,0.0,
27,FE Fisher (NZ),1953-1953,1,1,0,0,0,0,0,0,0.0,
28,JA Flavell (ENG),1961-1964,4,7,0,0,0,0,0,0,0.0,
29,LO Fleetwood-Smith (AUS),1935-1938,10,18,0,0,0,0,0,0,0.0,
30,CE Floquet (SA),1910-1910,1,2,0,0,0,0,0,0,0.0,
31,H Foley (NZ),1930-1930,1,2,0,0,0,0,0,0,0.0,
32,AJ Fothergill (ENG),1889-1889,2,4,0,0,0,0,0,0,0.0,
33,CN Frank (SA),1921-1921,3,6,0,0,0,0,0,0,0.0,
34,WHB Frank (SA),1896-1896,1,1,0,0,0,0,0,0,0.0,
35,MC Frederick (WI),1954-1954,1,2,0,0,0,0,0,0,0.0,
36,DL Freeman (NZ),1933-1933,2,2,0,0,0,0,0,0,0.0,
37,FAW Freer (AUS),1946-1946,1,2,0,0,0,0,0,0,0.0,
38,RL Fuller (WI),1935-1935,1,2,0,0,0,0,0,0,0.0,
39,HA Furlonge (WI),1955-1956,3,5,0,0,0,0,0,0,0.0,
40,HG Gaekwad (INDIA),1952-1952,1,1,0,0,0,0,0,0,0.0,
41,IS Gallage (SL),1999-1999,1,2,0,0,0,0,0,0,0.0,
42,N Gallichan (NZ),1937-1937,1,2,0,0,0,0,0,0,0.0,
43,PLS Gamage (SL),2017-2018,5,9,0,0,0,0,0,0,0.0,
44,D Ganesh (INDIA),1997-1997,4,7,0,0,0,0,0,0,0.0,
45,AG Ganteaume (WI),1948-1948,1,2,0,0,0,0,0,0,0.0,
46,SG Gedye (NZ),1964-1965,4,8,0,0,0,0,0,0,0.0,
47,PR George (AUS),2010-2010,1,2,0,0,0,0,0,0,0.0,
48,MEZ Ghazali (PAK),1954-1954,2,2,0,0,0,0,0,0,0.0,
49,Ghulam Abbas (PAK),1967-1967,1,2,0,0,0,0,0,0,0.0,
0,OD Gibson (WI),1995-1999,2,4,0,0,0,0,0,0,0.0,
1,ESH Giddins (ENG),1999-2000,4,7,0,0,0,0,0,0,0.0,
2,DR Gilbert (AUS),1985-1986,9,13,0,0,0,0,0,0,0.0,
3,SR Gillespie (NZ),1986-1986,1,1,0,0,0,0,0,0,0.0,
4,AHH Gilligan (ENG),1930-1930,4,6,0,0,0,0,0,0,0.0,
5,G Gladstone (WI),1930-1930,1,2,0,0,0,0,0,0,0.0,
6,GK Glover (SA),1896-1896,1,1,0,0,0,0,0,0,0.0,
7,DW Gregory (AUS),1877-1879,3,6,0,0,0,0,0,0,0.0,
8,IA Greig (ENG),1982-1982,2,4,0,0,0,0,0,0,0.0,
9,BAF Grieve (ENG),1889-1889,2,4,0,0,0,0,0,0,0.0,
10,GM Griffin (SA),1960-1960,2,3,0,0,0,0,0,0,0.0,
11,TU Groube (AUS),1880-1880,1,2,0,0,0,0,0,0,0.0,
12,CEJ Guest (AUS),1963-1963,1,2,0,0,0,0,0,0,0.0,
13,RPW Guneratne (SL),1983-1983,1,1,0,0,0,0,0,0,0.0,
14,BP Gupte (INDIA),1961-1965,3,5,0,0,0,0,0,0,0.0,
15,A Habib (ENG),1999-1999,2,4,0,0,0,0,0,0,0.0,
16,GG Hall (SA),1965-1965,1,2,0,0,0,0,0,0,0.0,
17,C Hallows (ENG),1921-1928,2,3,0,0,0,0,0,0,0.0,
18,GM Hamilton (ENG),1999-1999,1,1,0,0,0,0,0,0,0.0,
19,RHM Hands (SA),1914-1914,1,2,0,0,0,0,0,0,0.0,
20,MA Hanley (SA),1949-1949,1,2,0,0,0,0,0,0,0.0,
21,HTW Hardinge (ENG),1921-1921,1,2,0,0,0,0,0,0,0.0,
22,NS Harford (NZ),1955-1958,8,11,0,0,0,0,0,0,0.0,
23,RM Harris (NZ),1959-1959,2,2,0,0,0,0,0,0,0.0,
24,GPD Hartigan (SA),1912-1914,5,6,0,0,0,0,0,0,0.0,
25,AEV Hartkopf (AUS),1925-1925,1,2,0,0,0,0,0,0,0.0,
26,MR Harvey (AUS),1947-1947,1,2,0,0,0,0,0,0,0.0,
27,RL Harvey (SA),1936-1936,2,2,0,0,0,0,0,0,0.0,
28,Harvinder Singh (INDIA),1998-2001,3,6,0,0,0,0,0,0,0.0,
29,GG Hearne (ENG),1892-1892,1,2,0,0,0,0,0,0,0.0,
30,D Hettiarachchi (SL),2001-2001,1,2,0,0,0,0,0,0,0.0,
31,CFW Hime (SA),1896-1896,1,2,0,0,0,0,0,0,0.0,
32,JR Hodges (AUS),1877-1877,2,4,0,0,0,0,0,0,0.0,
33,JL Hopwood (ENG),1934-1934,2,3,0,0,0,0,0,0,0.0,
34,AN Hornby (ENG),1879-1884,3,5,0,0,0,0,0,0,0.0,
35,AB Howard (WI),1972-1972,1,1,0,0,0,0,0,0,0.0,
36,H Howell (ENG),1920-1924,5,8,0,0,0,0,0,0,0.0,
37,Humayun Farhat (PAK),2001-2001,1,1,0,0,0,0,0,0,0.0,
38,KC Ibrahim (INDIA),1948-1949,4,6,0,0,0,0,0,0,0.0,
39,J Iddon (ENG),1935-1935,5,9,0,0,0,0,0,0,0.0,
40,Iftikhar Anjum (PAK),2006-2006,1,2,0,0,0,0,0,0,0.0,
41,Ijaz Faqih (PAK),1980-1988,5,8,0,0,0,0,0,0,0.0,
42,MC Ilott (ENG),1993-1995,5,8,0,0,0,0,0,0,0.0,
43,Imran Khan (PAK),2014-2019,10,19,0,0,0,0,0,0,0.0,
44,PJ Ingram (NZ),2010-2010,2,4,0,0,0,0,0,0,0.0,
45,RD Jackman (ENG),1981-1982,4,7,0,0,0,0,0,0,0.0,
46,AS Jaggernauth (WI),2008-2008,1,2,0,0,0,0,0,0,0.0,
47,LP Jai (INDIA),1933-1933,1,2,0,0,0,0,0,0,0.0,
48,Jalal-ud-Din (PAK),1982-1985,6,9,0,0,0,0,0,0,0.0,
49,SP James (ENG),1998-1998,2,4,0,0,0,0,0,0,0.0,
0,JA Jameson (ENG),1971-1974,4,6,0,0,0,0,0,0,0.0,
1,Javed Ahmadi (AFG),2018-2019,2,3,0,0,0,0,0,0,0.0,
2,Javed Akhtar (PAK),1962-1962,1,1,0,0,0,0,0,0,0.0,
3,HK Jayantilal (INDIA),1971-1971,1,2,0,0,0,0,0,0,0.0,
4,RSA Jayasekera (SL),1982-1982,1,1,0,0,0,0,0,0,0.0,
5,S Jeganathan (SL),1983-1983,2,3,0,0,0,0,0,0,0.0,
6,DJ Johnson (INDIA),1996-1996,2,4,0,0,0,0,0,0,0.0,
7,HHH Johnson (WI),1948-1950,3,6,0,0,0,0,0,0,0.0,
8,RL Johnson (ENG),2003-2003,3,6,0,0,0,0,0,0,0.0,
9,RA Jones (NZ),2003-2003,1,2,0,0,0,0,0,0,0.0,
10,LR Joslin (AUS),1968-1968,1,2,0,0,0,0,0,0,0.0,
11,Kamrul Islam Rabbi (BDESH),2016-2018,7,13,0,0,0,0,0,0,0.0,
12,TP Kamungozi (ZIM),2014-2014,1,2,0,0,0,0,0,0,0.0,
13,TE Kane (IRE),2018-2018,1,2,0,0,0,0,0,0,0.0,
14,HH Kanitkar (INDIA),1999-2000,2,3,0,0,0,0,0,0,0.0,
15,HS Kanitkar (INDIA),1974-1974,2,3,0,0,0,0,0,0,0.0,
16,WW Keeton (ENG),1934-1939,2,2,0,0,0,0,0,0,0.0,
17,GA Kempis (SA),1889-1889,1,2,0,0,0,0,0,0,0.0,
18,SC Kerrigan (ENG),2013-2013,1,2,0,0,0,0,0,0,0.0,
19,Khalid Hasan (PAK),1954-1954,1,1,0,0,0,0,0,0,0.0,
20,Khalid Wazir (PAK),1954-1954,2,2,0,0,0,0,0,0,0.0,
21,A Khan (ENG),2009-2009,1,2,0,0,0,0,0,0,0.0,
22,JH King (ENG),1909-1909,1,2,0,0,0,0,0,0,0.0,
23,SP Kinneir (ENG),1911-1911,1,2,0,0,0,0,0,0,0.0,
24,NA Knox (ENG),1907-1907,2,4,0,0,0,0,0,0,0.0,
25,CKB Kulasekara (SL),2011-2011,1,2,0,0,0,0,0,0,0.0,
26,UN Kulkarni (INDIA),1967-1968,4,8,0,0,0,0,0,0,0.0,
27,AK Kuruppuarachchi (SL),1986-1987,2,3,0,0,0,0,0,0,0.0,
28,A Kuruvilla (INDIA),1997-1997,10,15,0,0,0,0,0,0,0.0,
29,F Kuys (SA),1899-1899,1,2,0,0,0,0,0,0,0.0,
30,MN Lathwell (ENG),1993-1993,2,3,0,0,0,0,0,0,0.0,
31,DV Lawrence (ENG),1988-1992,5,10,0,0,0,0,0,0,0.0,
32,HW Lee (ENG),1931-1931,1,2,0,0,0,0,0,0,0.0,
33,JG Leggat (NZ),1952-1956,9,10,0,0,0,0,0,0,0.0,
34,FL le Roux (SA),1914-1914,1,2,0,0,0,0,0,0,0.0,
35,AR Lewis (ENG),1972-1973,9,17,0,0,0,0,0,0,0.0,
36,J Lewis (ENG),2006-2006,1,2,0,0,0,0,0,0,0.0,
37,PT Lewis (SA),1913-1913,1,1,0,0,0,0,0,0,0.0,
38,RN Lewis (WI),1997-2008,5,9,0,0,0,0,0,0,0.0,
39,GF Linde (SA),2019-2019,1,1,0,0,0,0,0,0,0.0,
40,DK Liyanage (SL),1992-2001,9,15,0,0,0,0,0,0,0.0,
41,TA Lloyd (ENG),1984-1984,1,1,0,0,0,0,0,0,0.0,
42,ACI Lock (ZIM),1995-1995,1,2,0,0,0,0,0,0,0.0,
43,GR Loveridge (NZ),1996-1996,1,2,0,0,0,0,0,0,0.0,
44,EB Lundie (SA),1914-1914,1,2,0,0,0,0,0,0,0.0,
45,MJ Macaulay (SA),1965-1965,1,2,0,0,0,0,0,0,0.0,
46,AR McBrine (IRE),2019-2019,2,4,0,0,0,0,0,0,0.0,
47,JCW MacBryan (ENG),1924-1924,1,1,0,0,0,0,0,0,0.0,
48,BE McGain (AUS),2009-2009,1,1,0,0,0,0,0,0,0.0,
49,HM McGirr (NZ),1930-1930,2,3,0,0,0,0,0,0,0.0,
0,PE McIntyre (AUS),1995-1996,2,4,0,0,0,0,0,0,0.0,
1,AJ McKay (NZ),2010-2010,1,1,0,0,0,0,0,0,0.0,
2,FA MacKinnon (ENG),1879-1879,1,2,0,0,0,0,0,0,0.0,
3,JW McLaren (AUS),1912-1912,1,2,0,0,0,0,0,0,0.0,
4,R McLaren (SA),2010-2014,2,4,0,0,0,0,0,0,0.0,
5,EG McLeod (NZ),1930-1930,1,2,0,0,0,0,0,0,0.0,
6,JEP McMaster (ENG),1889-1889,1,2,0,0,0,0,0,0,0.0,
7,DAN McRae (NZ),1946-1946,1,1,0,0,0,0,0,0,0.0,
8,MAWR Madurasinghe (SL),1988-1992,3,5,0,0,0,0,0,0,0.0,
9,Mahbubul Alam (BDESH),2008-2008,4,6,0,0,0,0,0,0,0.0,
10,SI Mahmood (ENG),2006-2007,8,14,0,0,0,0,0,0,0.0,
11,JWH Makepeace (ENG),1920-1921,4,7,0,0,0,0,0,0,0.0,
12,NA Mallender (ENG),1992-1992,2,4,0,0,0,0,0,0,0.0,
13,MF Malone (AUS),1977-1977,1,2,0,0,0,0,0,0,0.0,
14,LA Markham (SA),1949-1949,1,2,0,0,0,0,0,0,0.0,
15,VJ Marks (ENG),1982-1984,6,12,0,0,0,0,0,0,0.0,
16,AP Marr (AUS),1885-1885,1,2,0,0,0,0,0,0,0.0,
17,NE Marshall (WI),1955-1955,1,2,0,0,0,0,0,0,0.0,
18,BP Martin (NZ),2013-2013,5,9,0,0,0,0,0,0,0.0,
19,JW Martin (ENG),1947-1947,1,2,0,0,0,0,0,0,0.0,
20,WFE Marx (SA),1921-1921,3,6,0,0,0,0,0,0,0.0,
21,MJ Mason (NZ),2004-2004,1,2,0,0,0,0,0,0,0.0,
22,Masood Anwar (PAK),1990-1990,1,2,0,0,0,0,0,0,0.0,
23,PS Masvaure (ZIM),2016-2016,2,3,0,0,0,0,0,0,0.0,
24,EZ Matambanadzo (ZIM),1996-1999,3,6,0,0,0,0,0,0,0.0,
25,T Meale (NZ),1958-1958,2,3,0,0,0,0,0,0,0.0,
26,JM Mennie (AUS),2016-2016,1,1,0,0,0,0,0,0,0.0,
27,KO Meth (ZIM),2013-2013,2,4,0,0,0,0,0,0,0.0,
28,EM Meuli (NZ),1953-1953,1,1,0,0,0,0,0,0,0.0,
29,AM Miller (ENG),1896-1896,1,2,0,0,0,0,0,0,0.0,
30,NO Miller (WI),2009-2009,1,2,0,0,0,0,0,0,0.0,
31,RC Miller (WI),1953-1953,1,2,0,0,0,0,0,0,0.0,
32,RB Minnett (AUS),1911-1912,9,16,0,0,0,0,0,0,0.0,
33,Miran Bakhsh (PAK),1955-1955,2,4,0,0,0,0,0,0,0.0,
34,SF Mire (ZIM),2017-2017,2,3,0,0,0,0,0,0,0.0,
35,Mir Hamza (PAK),2018-2018,1,2,0,0,0,0,0,0,0.0,
36,DJ Mitchell (NZ),2019-2019,1,1,0,0,0,0,0,0,0.0,
37,NS Mitchell-Innes (ENG),1935-1935,1,2,0,0,0,0,0,0,0.0,
38,A Mithun (INDIA),2010-2011,4,8,0,0,0,0,0,0,0.0,
39,Mohammad Aslam (PAK),1954-1954,1,1,0,0,0,0,0,0,0.0,
40,Mohammad Irfan (PAK),2013-2013,4,6,0,0,0,0,0,0,0.0,
41,Mohammad Khalil (PAK),2004-2005,2,4,0,0,0,0,0,0,0.0,
42,Mohammad Munaf (PAK),1959-1962,4,8,0,0,0,0,0,0,0.0,
43,Mohammad Shahid (BDESH),2015-2015,5,6,0,0,0,0,0,0,0.0,
44,Mohammad Shahzad (AFG),2018-2019,2,3,0,0,0,0,0,0,0.0,
45,Mohammad Zahid (PAK),1996-2003,5,9,0,0,0,0,0,0,0.0,
46,DS Mohanty (INDIA),1997-1997,2,4,0,0,0,0,0,0,0.0,
47,JA Morkel (SA),2009-2009,1,2,0,0,0,0,0,0,0.0,
48,J Moroney (AUS),1949-1952,7,13,0,0,0,0,0,0,0.0,
49,S Morris (AUS),1885-1885,1,2,0,0,0,0,0,0,0.0,
0,JK Moss (AUS),1979-1979,1,2,0,0,0,0,0,0,0.0,
1,VM Muddiah (INDIA),1959-1960,2,3,0,0,0,0,0,0,0.0,
2,GH Mudie (WI),1935-1935,1,2,0,0,0,0,0,0,0.0,
3,Muhammad Musa (PAK),2019-2019,1,1,0,0,0,0,0,0,0.0,
4,Mujeeb Ur Rahman (AFG),2018-2018,1,1,0,0,0,0,0,0,0.0,
5,PWA Mulder (SA),2019-2019,1,2,0,0,0,0,0,0,0.0,
6,C Munro (NZ),2013-2013,1,1,0,0,0,0,0,0,0.0,
7,TA Munton (ENG),1992-1992,2,4,0,0,0,0,0,0,0.0,
8,T Mupariwa (ZIM),2004-2004,1,1,0,0,0,0,0,0,0.0,
9,TJ Murtagh (IRE),2018-2019,3,6,0,0,0,0,0,0,0.0,
10,TK Musakanda (ZIM),2017-2017,1,2,0,0,0,0,0,0,0.0,
11,HA Musgrove (AUS),1885-1885,1,2,0,0,0,0,0,0,0.0,
12,DT Mutendera (ZIM),2000-2000,1,2,0,0,0,0,0,0,0.0,
13,F Mutizwa (ZIM),2012-2012,1,1,0,0,0,0,0,0,0.0,
14,B Muzarabani (ZIM),2017-2017,1,1,0,0,0,0,0,0,0.0,
15,W Mwayenga (ZIM),2005-2005,1,2,0,0,0,0,0,0,0.0,
16,Nadeem Ghauri (PAK),1990-1990,1,1,0,0,0,0,0,0,0.0,
17,Nadeem Khan (PAK),1993-1999,2,4,0,0,0,0,0,0,0.0,
18,LE Nagel (AUS),1932-1932,1,2,0,0,0,0,0,0,0.0,
19,SS Naik (INDIA),1974-1975,3,4,0,0,0,0,0,0,0.0,
20,Naoomal Jaoomal (INDIA),1932-1934,3,6,0,0,0,0,0,0,0.0,
21,Naseem Shah (PAK),2019-2019,3,4,0,0,0,0,0,0,0.0,
22,Nasir Jamal (AFG),2019-2019,1,2,0,0,0,0,0,0,0.0,
23,Naved Anjum (PAK),1989-1990,2,4,0,0,0,0,0,0,0.0,
24,Naved Ashraf (PAK),1998-2000,2,4,0,0,0,0,0,0,0.0,
25,Naved Latif (PAK),2002-2002,1,2,0,0,0,0,0,0,0.0,
26,MN Nawaz (SL),2002-2002,1,2,0,0,0,0,0,0,0.0,
27,S Nazir Ali (INDIA),1932-1934,2,4,0,0,0,0,0,0,0.0,
28,Nazmul Hossain (BDESH),2004-2011,2,3,0,0,0,0,0,0,0.0,
29,Nazmul Islam (BDESH),2018-2018,1,2,0,0,0,0,0,0,0.0,
30,JM Neblett (WI),1935-1935,1,2,0,0,0,0,0,0,0.0,
31,W Newham (ENG),1888-1888,1,2,0,0,0,0,0,0,0.0,
32,J Newman (NZ),1932-1933,3,3,0,0,0,0,0,0,0.0,
33,MJ Nicholson (AUS),1998-1998,1,2,0,0,0,0,0,0,0.0,
34,JFW Nicolson (SA),1928-1928,3,6,0,0,0,0,0,0,0.0,
35,RAP Nissanka (SL),2003-2003,4,7,0,0,0,0,0,0,0.0,
36,A Nortje (SA),2019-2019,3,4,0,0,0,0,0,0,0.0,
37,NO Norton (SA),1910-1910,1,2,0,0,0,0,0,0,0.0,
38,OE Nothling (AUS),1928-1928,1,2,0,0,0,0,0,0,0.0,
39,S Nyalchand (INDIA),1952-1952,1,1,0,0,0,0,0,0,0.0,
40,KJ O'Brien (IRE),2018-2019,3,6,0,0,0,0,0,0,0.0,
41,AE Ochse (SA),1889-1889,2,3,0,0,0,0,0,0,0.0,
42,SNJ O'Keefe (AUS),2014-2017,9,16,0,0,0,0,0,0,0.0,
43,N Oldfield (ENG),1939-1939,1,1,0,0,0,0,0,0,0.0,
44,AH Omarshah (ZIM),1992-1996,3,5,0,0,0,0,0,0,0.0,
45,G Onions (ENG),2009-2012,9,16,0,0,0,0,0,0,0.0,
46,J Ormond (ENG),2001-2001,2,3,0,0,0,0,0,0,0.0,
47,DEV Padgett (ENG),1960-1960,2,4,0,0,0,0,0,0,0.0,
48,AL Padmore (WI),1976-1976,2,4,0,0,0,0,0,0,0.0,
49,DJ Pagon (WI),2005-2005,2,4,0,0,0,0,0,0,0.0,
0,AM Pai (INDIA),1969-1969,1,2,0,0,0,0,0,0,0.0,
1,PE Palia (INDIA),1932-1936,2,4,0,0,0,0,0,0,0.0,
2,CH Palmer (ENG),1954-1954,1,2,0,0,0,0,0,0,0.0,
3,KE Palmer (ENG),1965-1965,1,2,0,0,0,0,0,0,0.0,
4,RL Park (AUS),1920-1921,1,2,0,0,0,0,0,0,0.0,
5,RD Parkar (INDIA),1972-1973,2,4,0,0,0,0,0,0,0.0,
6,CWL Parker (ENG),1921-1921,1,1,0,0,0,0,0,0,0.0,
7,GM Parker (SA),1924-1924,2,2,0,0,0,0,0,0,0.0,
8,PWG Parker (ENG),1981-1981,1,2,0,0,0,0,0,0,0.0,
9,JH Parks (ENG),1937-1937,1,2,0,0,0,0,0,0,0.0,
10,DD Parsana (INDIA),1979-1979,2,4,0,0,0,0,0,0,0.0,
11,Nawab of Pataudi snr (ENG/INDIA),1932-1946,6,11,0,0,0,0,0,0,0.0,
12,DJ Pattinson (ENG),2008-2008,1,2,0,0,0,0,0,0,0.0,
13,F Penn (ENG),1880-1880,1,2,0,0,0,0,0,0,0.0,
14,KK Peters (WI),2014-2014,1,1,0,0,0,0,0,0,0.0,
15,WN Phillips (AUS),1992-1992,1,2,0,0,0,0,0,0,0.0,
16,LR Pierre (WI),1948-1948,1,2,0,0,0,0,0,0,0.0,
17,ACS Pigott (ENG),1984-1984,1,1,0,0,0,0,0,0,0.0,
18,W Place (ENG),1948-1948,3,6,0,0,0,0,0,0,0.0,
19,JB Plimsoll (SA),1947-1947,1,2,0,0,0,0,0,0,0.0,
20,GH Pope (ENG),1947-1947,1,2,0,0,0,0,0,0,0.0,
21,RJ Pope (AUS),1885-1885,1,2,0,0,0,0,0,0,0.0,
22,RR Powar (INDIA),2007-2007,2,4,0,0,0,0,0,0,0.0,
23,S Prasanna (SL),2011-2011,1,1,0,0,0,0,0,0,0.0,
24,D Pretorius (SA),2002-2003,4,8,0,0,0,0,0,0,0.0,
25,RM Prideaux (ENG),1968-1969,3,6,0,0,0,0,0,0,0.0,
26,MW Priest (NZ),1990-1998,3,5,0,0,0,0,0,0,0.0,
27,CFH Prince (SA),1899-1899,1,2,0,0,0,0,0,0,0.0,
28,MW Pringle (SA),1992-1995,4,7,0,0,0,0,0,0,0.0,
29,Qaiser Abbas (PAK),2000-2000,1,2,0,0,0,0,0,0,0.0,
30,Qais Ahmad (AFG),2019-2019,1,2,0,0,0,0,0,0,0.0,
31,NV Radford (ENG),1986-1988,3,6,0,0,0,0,0,0,0.0,
32,Rafiqul Islam (BDESH),2002-2002,1,1,0,0,0,0,0,0,0.0,
33,S Ragoonath (WI),1999-1999,2,4,0,0,0,0,0,0,0.0,
34,K Rai Singh (INDIA),1948-1948,1,2,0,0,0,0,0,0,0.0,
35,Rajinder Pal (INDIA),1964-1964,1,2,0,0,0,0,0,0,0.0,
36,C Ramaswami (INDIA),1936-1936,2,3,0,0,0,0,0,0,0.0,
37,AN Ranasinghe (SL),1982-1982,2,4,0,0,0,0,0,0,0.0,
38,D Ranatunga (SL),1989-1989,2,4,0,0,0,0,0,0,0.0,
39,U Ranchod (ZIM),1993-1993,1,1,0,0,0,0,0,0,0.0,
40,CR Rangachari (INDIA),1948-1948,4,4,0,0,0,0,0,0,0.0,
41,WB Rankin (ENG/IRE),2014-2019,3,6,0,0,0,0,0,0,0.0,
42,Rashid Khan (AFG),2018-2019,4,7,0,0,0,0,0,0,0.0,
43,V Razdan (INDIA),1989-1989,2,2,0,0,0,0,0,0,0.0,
44,HD Read (ENG),1935-1935,1,2,0,0,0,0,0,0,0.0,
45,RE Redmond (NZ),1973-1973,1,2,0,0,0,0,0,0,0.0,
46,N Reid (SA),1921-1921,1,2,0,0,0,0,0,0,0.0,
47,RA Reifer (WI),2017-2017,1,2,0,0,0,0,0,0,0.0,
48,HJ Rhodes (ENG),1959-1959,2,4,0,0,0,0,0,0,0.0,
49,Riaz Afridi (PAK),2004-2004,1,2,0,0,0,0,0,0,0.0,
0,AR Richards (SA),1896-1896,1,1,0,0,0,0,0,0,0.0,
1,WHM Richards (SA),1889-1889,1,1,0,0,0,0,0,0,0.0,
2,JA Richardson (AUS),2019-2019,2,4,0,0,0,0,0,0,0.0,
3,TL Richmond (ENG),1921-1921,1,2,0,0,0,0,0,0,0.0,
4,KR Rickards (WI),1948-1952,2,4,0,0,0,0,0,0,0.0,
5,AT Roberts (WI),1956-1956,1,2,0,0,0,0,0,0,0.0,
6,LA Roberts (WI),1999-1999,1,2,0,0,0,0,0,0,0.0,
7,GK Robertson (NZ),1986-1986,1,2,0,0,0,0,0,0,0.0,
8,WR Robertson (AUS),1885-1885,1,2,0,0,0,0,0,0,0.0,
9,TS Roland-Jones (ENG),2017-2017,4,8,0,0,0,0,0,0,0.0,
10,AK Roy (INDIA),1969-1969,4,8,0,0,0,0,0,0,0.0,
11,FE Rumsey (ENG),1964-1965,5,10,0,0,0,0,0,0,0.0,
12,MW Rushmere (SA),1992-1992,1,2,0,0,0,0,0,0,0.0,
13,JW Rutherford (AUS),1956-1956,1,2,0,0,0,0,0,0,0.0,
14,Sajedul Islam (BDESH),2008-2013,3,5,0,0,0,0,0,0,0.0,
15,RL Sanghvi (INDIA),2001-2001,1,2,0,0,0,0,0,0,0.0,
16,CT Sarwate (INDIA),1946-1951,9,13,0,0,0,0,0,0,0.0,
17,RC Saxena (INDIA),1967-1967,1,2,0,0,0,0,0,0,0.0,
18,CP Schofield (ENG),2000-2000,2,4,0,0,0,0,0,0,0.0,
19,SS Schultz (ENG),1879-1879,1,2,0,0,0,0,0,0,0.0,
20,AHP Scott (WI),1953-1953,1,2,0,0,0,0,0,0,0.0,
21,OC Scott (WI),1928-1931,8,11,0,0,0,0,0,0,0.0,
22,RH Scott (NZ),1947-1947,1,1,0,0,0,0,0,0,0.0,
23,BJ Sealey (WI),1933-1933,1,1,0,0,0,0,0,0,0.0,
24,TAP Sekhar (INDIA),1983-1983,2,2,0,0,0,0,0,0,0.0,
25,AK Sengupta (INDIA),1959-1959,1,2,0,0,0,0,0,0,0.0,
26,DG Sewell (NZ),1997-1997,1,2,0,0,0,0,0,0,0.0,
27,Shafiq Ahmed (PAK),1974-1981,6,10,0,0,0,0,0,0,0.0,
28,Shaheen Shah Afridi (PAK),2018-2019,7,11,0,0,0,0,0,0,0.0,
29,Shahid Mahboob (PAK),1989-1989,1,1,0,0,0,0,0,0,0.0,
30,Shahid Mahmood (PAK),1962-1962,1,1,0,0,0,0,0,0,0.0,
31,Shahid Saeed (PAK),1989-1989,1,2,0,0,0,0,0,0,0.0,
32,T Shamsi (SA),2016-2018,2,4,0,0,0,0,0,0,0.0,
33,Sharjeel Khan (PAK),2017-2017,1,2,0,0,0,0,0,0,0.0,
34,KV Sharma (INDIA),2014-2014,1,2,0,0,0,0,0,0,0.0,
35,SG Shinde (INDIA),1946-1952,7,13,0,0,0,0,0,0,0.0,
36,RC Shukla (INDIA),1982-1982,1,2,0,0,0,0,0,0,0.0,
37,J Shuter (ENG),1888-1888,1,2,0,0,0,0,0,0,0.0,
38,A Sidebottom (ENG),1985-1985,1,1,0,0,0,0,0,0,0.0,
39,RA Sinfield (ENG),1938-1938,1,2,0,0,0,0,0,0,0.0,
40,KN Slater (AUS),1959-1959,1,2,0,0,0,0,0,0,0.0,
41,J Slight (AUS),1880-1880,1,2,0,0,0,0,0,0,0.0,
42,TF Smailes (ENG),1946-1946,1,2,0,0,0,0,0,0,0.0,
43,MA Small (WI),1984-1984,2,4,0,0,0,0,0,0,0.0,
44,AM Smith (ENG),1997-1997,1,1,0,0,0,0,0,0,0.0,
45,CA Smith (ENG),1889-1889,1,2,0,0,0,0,0,0,0.0,
46,DBM Smith (AUS),1912-1912,2,3,0,0,0,0,0,0,0.0,
47,DM Smith (ENG),1986-1986,2,4,0,0,0,0,0,0,0.0,
48,DV Smith (ENG),1957-1957,3,6,0,0,0,0,0,0,0.0,
49,HD Smith (NZ),1933-1933,1,1,0,0,0,0,0,0,0.0,
0,GA Smithson (ENG),1948-1948,2,4,0,0,0,0,0,0,0.0,
1,CA Snedden (NZ),1947-1947,1,1,0,0,0,0,0,0,0.0,
2,Sohrawordi Shuvo (BDESH),2011-2011,1,2,0,0,0,0,0,0,0.0,
3,WER Somerville (NZ),2018-2019,3,6,0,0,0,0,0,0,0.0,
4,MM Sood (INDIA),1960-1960,1,1,0,0,0,0,0,0,0.0,
5,TE Srinivasan (INDIA),1981-1981,1,2,0,0,0,0,0,0,0.0,
6,SJ Staples (ENG),1928-1928,3,6,0,0,0,0,0,0,0.0,
7,SC Stayers (WI),1962-1962,4,8,0,0,0,0,0,0,0.0,
8,JP Stephenson (ENG),1989-1989,1,2,0,0,0,0,0,0,0.0,
9,GB Stevenson (ENG),1980-1981,2,3,0,0,0,0,0,0,0.0,
10,PJR Steyn (SA),1995-1995,3,6,0,0,0,0,0,0,0.0,
11,EL St Hill (WI),1930-1930,2,4,0,0,0,0,0,0,0.0,
12,VH Stollmeyer (WI),1939-1939,1,2,0,0,0,0,0,0,0.0,
13,OP Stone (ENG),2019-2019,1,2,0,0,0,0,0,0,0.0,
14,Subashis Roy (BDESH),2017-2017,4,7,0,0,0,0,0,0,0.0,
15,FH Sugg (ENG),1888-1888,2,4,0,0,0,0,0,0,0.0,
16,GR Sunderam (INDIA),1955-1956,2,4,0,0,0,0,0,0,0.0,
17,Sunzamul Islam (BDESH),2018-2018,1,1,0,0,0,0,0,0,0.0,
18,VN Swamy (INDIA),1955-1955,1,2,0,0,0,0,0,0,0.0,
19,Syed Rasel (BDESH),2005-2007,6,8,0,0,0,0,0,0,0.0,
20,HM Taberer (SA),1902-1902,1,2,0,0,0,0,0,0,0.0,
21,VM Tancred (SA),1899-1899,1,2,0,0,0,0,0,0,0.0,
22,LE Tapscott (SA),1923-1923,2,4,0,0,0,0,0,0,0.0,
23,KK Tarapore (INDIA),1948-1948,1,1,0,0,0,0,0,0,0.0,
24,AI Taylor (SA),1956-1956,1,2,0,0,0,0,0,0,0.0,
25,D Taylor (SA),1914-1914,2,4,0,0,0,0,0,0,0.0,
26,JO Taylor (WI),1958-1959,3,5,0,0,0,0,0,0,0.0,
27,JP Taylor (ENG),1993-1994,2,4,0,0,0,0,0,0,0.0,
28,SN Thakur (INDIA),2018-2018,1,2,0,0,0,0,0,0,0.0,
29,NHCD Theunissen (SA),1889-1889,1,1,0,0,0,0,0,0,0.0,
30,JG Thomas (ENG),1986-1986,5,9,0,0,0,0,0,0,0.0,
31,PIC Thompson (WI),1996-1997,2,3,0,0,0,0,0,0,0.0,
32,SR Thompson (IRE),2018-2019,3,6,0,0,0,0,0,0,0.0,
33,GR Thoms (AUS),1952-1952,1,2,0,0,0,0,0,0,0.0,
34,AL Thomson (AUS),1970-1971,4,8,0,0,0,0,0,0,0.0,
35,K Thomson (NZ),1968-1968,2,4,0,0,0,0,0,0,0.0,
36,HM Thurlow (AUS),1932-1932,1,2,0,0,0,0,0,0,0.0,
37,DS Tomlinson (SA),1935-1935,1,1,0,0,0,0,0,0,0.0,
38,GC Tonge (WI),2009-2009,1,2,0,0,0,0,0,0,0.0,
39,CL Townsend (ENG),1899-1899,2,4,0,0,0,0,0,0,0.0,
40,MF Tremlett (ENG),1948-1948,3,6,0,0,0,0,0,0,0.0,
41,GE Tribe (AUS),1946-1947,3,6,0,0,0,0,0,0,0.0,
42,PS Twentyman-Jones (SA),1902-1902,1,2,0,0,0,0,0,0,0.0,
43,EJ Tyler (ENG),1896-1896,1,2,0,0,0,0,0,0,0.0,
44,JD Unadkat (INDIA),2010-2010,1,1,0,0,0,0,0,0,0.0,
45,KEA Upashantha (SL),1999-2002,2,4,0,0,0,0,0,0,0.0,
46,Usman Salahuddin (PAK),2018-2018,1,1,0,0,0,0,0,0,0.0,
47,Usman Shinwari (PAK),2019-2019,1,1,0,0,0,0,0,0,0.0,
48,VA Valentine (WI),1933-1933,2,2,0,0,0,0,0,0,0.0,
49,RH Vance (NZ),1988-1989,4,4,0,0,0,0,0,0,0.0,
0,GD Varnals (SA),1964-1965,3,4,0,0,0,0,0,0,0.0,
1,GF Vernon (ENG),1882-1883,1,2,0,0,0,0,0,0,0.0,
2,GC Viljoen (SA),2016-2016,1,2,0,0,0,0,0,0,0.0,
3,R Vinay Kumar (INDIA),2012-2012,1,1,0,0,0,0,0,0,0.0,
4,J Vine (ENG),1912-1912,2,4,0,0,0,0,0,0,0.0,
5,Wafadar Momand (AFG),2018-2019,2,3,0,0,0,0,0,0,0.0,
6,LA Walcott (WI),1930-1930,1,2,0,0,0,0,0,0,0.0,
7,BGK Walker (NZ),2000-2002,5,8,0,0,0,0,0,0,0.0,
8,KP Walmsley (NZ),1995-2000,3,6,0,0,0,0,0,0,0.0,
9,Waqar Salamkheil (AFG),2019-2019,1,2,0,0,0,0,0,0,0.0,
10,KPJ Warnaweera (SL),1986-1994,10,15,0,0,0,0,0,0,0.0,
11,JJ Warr (ENG),1951-1951,2,3,0,0,0,0,0,0,0.0,
12,BT Watambwa (ZIM),2001-2002,6,11,0,0,0,0,0,0,0.0,
13,L Watt (NZ),1955-1955,1,2,0,0,0,0,0,0,0.0,
14,MG Webb (NZ),1971-1974,3,6,0,0,0,0,0,0,0.0,
15,KH Weekes (WI),1939-1939,2,4,0,0,0,0,0,0,0.0,
16,CDUS Weerasinghe (SL),1985-1985,1,2,0,0,0,0,0,0,0.0,
17,AP Wells (ENG),1995-1995,1,1,0,0,0,0,0,0,0.0,
18,RJ Westcott (SA),1954-1958,5,8,0,0,0,0,0,0,0.0,
19,A Wharton (ENG),1949-1949,1,2,0,0,0,0,0,0,0.0,
20,DJ White (NZ),1990-1990,2,3,0,0,0,0,0,0,0.0,
21,DW White (ENG),1961-1962,2,4,0,0,0,0,0,0,0.0,
22,PE Whitelaw (NZ),1933-1933,2,2,0,0,0,0,0,0,0.0,
23,CV Wight (WI),1928-1930,2,3,0,0,0,0,0,0,0.0,
24,GL Wight (WI),1953-1953,1,2,0,0,0,0,0,0,0.0,
25,KIW Wijegunawardene (SL),1991-1992,2,4,0,0,0,0,0,0,0.0,
26,G Wijekoon (SL),2005-2005,2,4,0,0,0,0,0,0,0.0,
27,PK Wijetunge (SL),1993-1993,1,2,0,0,0,0,0,0,0.0,
28,CA Wiles (WI),1933-1933,1,1,0,0,0,0,0,0,0.0,
29,LL Wilkinson (ENG),1938-1939,3,5,0,0,0,0,0,0,0.0,
30,ET Willett (WI),1973-1975,5,10,0,0,0,0,0,0,0.0,
31,NF Williams (ENG),1990-1990,1,1,0,0,0,0,0,0,0.0,
32,CM Willoughby (SA),2003-2003,2,4,0,0,0,0,0,0,0.0,
33,JT Willoughby (SA),1896-1896,2,3,0,0,0,0,0,0,0.0,
34,CEM Wilson (ENG),1899-1899,2,4,0,0,0,0,0,0,0.0,
35,ER Wilson (ENG),1921-1921,1,2,0,0,0,0,0,0,0.0,
36,JW Wilson (AUS),1956-1956,1,2,0,0,0,0,0,0,0.0,
37,P Wilson (AUS),1998-1998,1,1,0,0,0,0,0,0,0.0,
38,CS Wimble (SA),1892-1892,1,1,0,0,0,0,0,0,0.0,
39,KL Wishart (WI),1935-1935,1,2,0,0,0,0,0,0,0.0,
40,R Wood (ENG),1887-1887,1,2,0,0,0,0,0,0,0.0,
41,CW Wright (ENG),1896-1896,3,6,0,0,0,0,0,0,0.0,
42,EG Wynyard (ENG),1896-1906,3,6,0,0,0,0,0,0,0.0,
43,Yamin Ahmadzai (AFG),2018-2019,4,7,0,0,0,0,0,0,0.0,
44,Yasir Ali (PAK),2003-2003,1,2,0,0,0,0,0,0,0.0,
45,Yasir Arafat (PAK),2007-2009,3,5,0,0,0,0,0,0,0.0,
46,B Yograj Singh (INDIA),1981-1981,1,2,0,0,0,0,0,0,0.0,
47,S Young (AUS),1997-1997,1,2,0,0,0,0,0,0,0.0,
48,Younis Ahmed (PAK),1969-1987,4,7,0,0,0,0,0,0,0.0,
49,Zahir Khan (AFG),2019-2019,2,4,0,0,0,0,0,0,0.0,
0,Ziaur Rahman (BDESH),2013-2013,1,2,0,0,0,0,0,0,0.0,
