,Player,Span,Mat,Inns,Dis,Ct,St,Ct Wk,Ct Fi,MD,D/I,Unnamed: 11
0,MS Dhoni (INDIA),2006-2019,98,97,91,57,34,57,0,5 (5ct 0st),0.938,
1,AB de Villiers (SA),2006-2017,78,78,72,65,7,21,44,4 (4ct 0st),0.9229999999999999,
2,D Ramdin (WI),2006-2019,71,71,63,43,20,43,0,4 (4ct 0st),0.887,
3,Kamran Akmal (PAK),2006-2017,58,58,60,28,32,28,0,4 (0ct 4st),1.034,
4,Mushfiqur Rahim (BDESH),2006-2019,84,82,59,31,28,30,1,3 (1ct 2st),0.7190000000000001,
5,Mohammad Shahzad (AFG),2010-2018,65,65,54,26,28,26,0,5 (3ct 2st),0.83,
6,DA Miller (SA/World),2010-2019,72,72,52,51,1,1,50,4 (4ct 0st),0.722,
7,Umar Akmal (PAK),2009-2019,84,84,52,50,2,11,39,3 (3ct 0st),0.619,
8,Shoaib Malik (ICC/PAK),2006-2019,111,111,50,50,0,0,50,3 (3ct 0st),0.45,
9,Q de Kock (SA),2012-2019,38,38,46,36,10,36,0,4 (3ct 1st),1.21,
10,MJ Guptill (NZ),2009-2019,83,82,46,46,0,0,46,3 (3ct 0st),0.56,
11,GC Wilson (IRE),2008-2019,78,76,46,39,7,28,11,4 (3ct 1st),0.605,
12,KC Sangakkara (SL),2006-2014,56,56,45,25,20,25,0,3 (2ct 1st),0.8029999999999999,
13,Sarfaraz Ahmed (PAK),2010-2019,58,58,45,35,10,35,0,3 (3ct 0st),0.775,
14,BB McCullum (NZ),2005-2015,71,71,44,36,8,24,12,3 (3ct 0st),0.619,
15,LRPL Taylor (NZ),2006-2019,95,95,44,44,0,0,44,3 (3ct 0st),0.46299999999999997,
16,DA Warner (AUS),2009-2019,76,76,43,43,0,0,43,3 (3ct 0st),0.565,
17,SK Raina (INDIA),2006-2018,78,78,42,42,0,0,42,3 (3ct 0st),0.5379999999999999,
18,Mohammad Nabi (AFG),2010-2019,75,75,41,41,0,0,41,3 (3ct 0st),0.546,
19,RG Sharma (INDIA),2007-2019,104,104,38,38,0,0,38,3 (3ct 0st),0.365,
20,LD Chandimal (SL),2010-2018,54,54,37,32,5,15,17,4 (4ct 0st),0.685,
21,V Kohli (INDIA),2010-2019,75,75,37,37,0,0,37,3 (3ct 0st),0.493,
22,EJG Morgan (ENG),2009-2019,86,86,37,37,0,0,37,3 (3ct 0st),0.43,
23,GH Dockrell (IRE),2010-2019,73,70,36,36,0,0,36,3 (3ct 0st),0.514,
24,DJ Bravo (WI),2006-2016,66,66,35,35,0,0,35,3 (3ct 0st),0.53,
25,JP Duminy (SA),2007-2019,81,81,35,35,0,0,35,2 (2ct 0st),0.43200000000000005,
26,KJ O'Brien (IRE),2008-2019,90,86,34,34,0,0,34,2 (2ct 0st),0.395,
27,KA Pollard (WI),2008-2019,68,68,34,34,0,0,34,2 (2ct 0st),0.5,
28,MH Cross (SCOT),2013-2019,43,41,33,22,11,22,0,3 (2ct 1st),0.804,
29,TM Dilshan (SL),2006-2016,80,80,33,31,2,5,26,2 (2ct 0st),0.41200000000000003,
30,AD Hales (ENG),2011-2019,60,59,32,32,0,0,32,2 (2ct 0st),0.542,
31,BN Cooper (NL),2013-2019,51,50,31,31,0,0,31,2 (2ct 0st),0.62,
32,Mahmudullah (BDESH),2007-2019,83,81,31,31,0,0,31,2 (2ct 0st),0.382,
33,DJG Sammy (WI/World),2007-2017,68,68,31,31,0,0,31,4 (4ct 0st),0.455,
34,JM Bairstow (ENG),2011-2019,34,34,30,30,0,8,22,2 (2ct 0st),0.882,
35,GJ Maxwell (AUS),2012-2019,61,60,30,30,0,0,30,2 (2ct 0st),0.5,
36,NLTC Perera (ICC/SL/World),2010-2019,79,79,30,30,0,0,30,2 (2ct 0st),0.379,
37,L Ronchi (AUS/ICC/NZ),2008-2018,33,33,30,24,6,24,0,3 (3ct 0st),0.909,
38,Shahid Afridi (ICC/PAK),2006-2018,99,99,30,30,0,0,30,3 (3ct 0st),0.303,
39,TG Southee (NZ),2008-2019,66,65,29,29,0,0,29,2 (2ct 0st),0.446,
40,PW Borren (NL),2008-2017,43,41,28,28,0,0,28,4 (4ct 0st),0.682,
41,SA Edwards (NL),2018-2019,29,28,28,24,4,24,0,3 (3ct 0st),1.0,
42,PM Seelaar (NL),2008-2019,69,67,28,28,0,0,28,2 (2ct 0st),0.41700000000000004,
43,W Barresi (NL),2012-2019,42,40,27,26,1,26,0,4 (4ct 0st),0.675,
44,JC Buttler (ENG),2011-2018,66,65,27,23,4,21,2,3 (3ct 0st),0.415,
45,CS MacLeod (SCOT),2009-2019,49,49,27,27,0,0,27,4 (4ct 0st),0.551,
46,Najibullah Zadran (AFG),2012-2019,57,57,27,27,0,0,27,2 (2ct 0st),0.473,
47,NJ O'Brien (IRE),2008-2016,30,28,27,17,10,15,2,4 (3ct 1st),0.9640000000000001,
48,KS Williamson (NZ),2011-2019,57,56,27,27,0,0,27,3 (3ct 0st),0.48200000000000004,
49,NL McCullum (NZ),2007-2016,63,63,26,26,0,0,26,3 (3ct 0st),0.41200000000000003,
0,H Masakadza (ZIM),2006-2019,66,66,25,25,0,0,25,3 (3ct 0st),0.37799999999999995,
1,Mohammad Hafeez (PAK),2006-2018,89,89,25,25,0,0,25,2 (2ct 0st),0.28,
2,Sabbir Rahman (BDESH),2014-2019,44,43,25,25,0,0,25,3 (3ct 0st),0.581,
3,AJ Finch (AUS),2011-2019,58,57,24,24,0,0,24,3 (3ct 0st),0.42100000000000004,
4,DJ Hussey (AUS),2008-2012,39,39,24,24,0,0,24,2 (2ct 0st),0.615,
5,BJ Haddin (AUS),2006-2014,34,34,23,17,6,17,0,3 (3ct 0st),0.6759999999999999,
6,CJ Jordan (ENG),2014-2019,43,43,23,23,0,0,23,3 (3ct 0st),0.534,
7,AD Mathews (SL),2009-2018,72,72,23,23,0,0,23,2 (2ct 0st),0.319,
8,HH Pandya (INDIA),2016-2019,40,40,23,23,0,0,23,2 (2ct 0st),0.575,
9,Soumya Sarkar (BDESH),2015-2019,46,45,23,23,0,0,23,2 (2ct 0st),0.511,
10,SR Thompson (IRE),2014-2019,41,39,23,23,0,0,23,3 (3ct 0st),0.589,
11,CL White (AUS),2007-2014,47,47,23,23,0,0,23,2 (2ct 0st),0.489,
12,AT Carey (AUS),2018-2019,25,24,22,13,9,13,0,3 (1ct 2st),0.9159999999999999,
13,ADS Fletcher (WI),2008-2018,42,42,22,21,1,10,11,3 (2ct 1st),0.523,
14,WTS Porterfield (IRE),2008-2018,61,59,22,22,0,0,22,2 (2ct 0st),0.37200000000000005,
15,PR Stirling (IRE),2009-2019,72,71,22,22,0,0,22,3 (3ct 0st),0.309,
16,SCJ Broad (ENG),2006-2014,56,56,21,21,0,0,21,3 (3ct 0st),0.375,
17,F du Plessis (SA/World),2012-2019,44,44,21,21,0,0,21,2 (2ct 0st),0.47700000000000004,
18,SPD Smith (AUS),2010-2019,36,36,21,21,0,0,21,3 (3ct 0st),0.583,
19,Asghar Afghan (AFG),2010-2019,66,66,20,20,0,0,20,2 (2ct 0st),0.303,
20,MEK Hussey (AUS),2005-2012,38,38,20,20,0,0,20,3 (3ct 0st),0.526,
21,RA Jadeja (INDIA),2009-2019,46,46,20,20,0,0,20,2 (2ct 0st),0.434,
22,C Kieswetter (ENG),2010-2012,25,25,20,17,3,17,0,3 (2ct 1st),0.8,
23,SL Malinga (SL),2006-2019,79,79,20,20,0,0,20,2 (2ct 0st),0.253,
24,CO Obuya (KENYA),2007-2019,35,35,20,20,0,0,20,2 (2ct 0st),0.5710000000000001,
25,L Siaka (PNG),2015-2019,26,26,20,20,0,0,20,4 (4ct 0st),0.769,
26,LMP Simmons (WI),2007-2019,49,49,20,20,0,1,19,3 (3ct 0st),0.408,
27,SR Watson (AUS),2006-2016,58,58,20,20,0,0,20,2 (2ct 0st),0.344,
28,HM Amla (SA/World),2009-2018,44,44,19,19,0,0,19,2 (2ct 0st),0.431,
29,CJ Anderson (NZ),2012-2018,31,31,19,19,0,0,19,4 (4ct 0st),0.612,
30,MV Boucher (SA),2005-2010,25,25,19,18,1,18,0,3 (3ct 0st),0.76,
31,CR Brathwaite (WI),2011-2019,41,41,19,19,0,0,19,2 (2ct 0st),0.46299999999999997,
32,E Chigumbura (ZIM),2006-2019,54,54,19,19,0,0,19,2 (2ct 0st),0.35100000000000003,
33,KJ Coetzer (SCOT),2008-2019,58,56,19,19,0,0,19,2 (2ct 0st),0.33899999999999997,
34,KD Karthik (ICC/INDIA),2006-2019,32,31,19,14,5,6,8,3 (3ct 0st),0.612,
35,R Mutumbami (ZIM),2015-2019,22,22,19,15,4,11,4,4 (4ct 0st),0.863,
36,RR Patel (KENYA),2008-2019,30,30,19,19,0,0,19,3 (3ct 0st),0.633,
37,Shakib Al Hasan (BDESH),2006-2019,76,75,19,19,0,0,19,2 (2ct 0st),0.253,
38,BRM Taylor (ZIM),2006-2019,38,38,19,17,2,15,2,3 (3ct 0st),0.5,
39,RE van der Merwe (NL/SA),2009-2019,43,42,19,19,0,0,19,2 (2ct 0st),0.452,
40,C de Grandhomme (NZ),2012-2019,33,33,18,18,0,0,18,4 (4ct 0st),0.545,
41,S Dhawan (INDIA),2011-2019,58,58,18,18,0,0,18,2 (2ct 0st),0.31,
42,Gulbadin Naib (AFG),2012-2019,45,45,18,18,0,0,18,2 (2ct 0st),0.4,
43,MA Leask (SCOT),2013-2019,31,29,18,18,0,0,18,3 (3ct 0st),0.62,
44,C Munro (NZ),2012-2019,60,59,18,18,0,0,18,2 (2ct 0st),0.305,
45,JE Root (ENG),2012-2019,32,32,18,18,0,0,18,2 (2ct 0st),0.562,
46,Samiullah Shinwari (AFG),2010-2019,62,62,18,18,0,0,18,1 (1ct 0st),0.29,
47,GC Smith (SA),2005-2011,33,33,18,18,0,0,18,2 (2ct 0st),0.545,
48,Tamim Iqbal (BDESH/ICC/World),2007-2018,75,73,18,18,0,0,18,2 (2ct 0st),0.24600000000000002,
49,Umar Gul (PAK),2007-2016,60,60,18,18,0,0,18,2 (2ct 0st),0.3,
0,J Botha (SA),2006-2012,40,40,17,17,0,0,17,2 (2ct 0st),0.425,
1,AC Gilchrist (AUS),2005-2008,13,13,17,17,0,17,0,4 (4ct 0st),1.307,
2,DPMD Jayawardene (SL),2006-2014,55,55,17,17,0,0,17,2 (2ct 0st),0.309,
3,CK Kapugedera (SL),2006-2017,43,43,17,17,0,0,17,3 (3ct 0st),0.395,
4,KMDN Kulasekara (SL),2008-2017,58,58,17,17,0,0,17,2 (2ct 0st),0.293,
5,JA Morkel (SA),2005-2015,50,50,17,17,0,0,17,2 (2ct 0st),0.34,
6,MDKJ Perera (SL),2013-2019,42,42,17,13,4,7,6,3 (2ct 1st),0.40399999999999997,
7,Sikandar Raza (ZIM),2013-2019,32,32,17,17,0,0,17,2 (2ct 0st),0.531,
8,BDH Stevens (JER),2019-2019,17,17,17,17,0,0,17,3 (3ct 0st),1.0,
9,Sultan Ahmed (OMAN),2015-2017,17,16,17,14,3,14,0,3 (3ct 0st),1.062,
10,Babar Hayat (HKG),2014-2017,24,24,16,16,0,0,16,4 (4ct 0st),0.6659999999999999,
11,SW Billings (ENG/ICC),2015-2019,26,26,16,15,1,4,11,3 (2ct 1st),0.615,
12,K Doriga (PNG),2019-2019,17,17,16,15,1,15,0,5 (5ct 0st),0.941,
13,Hamza Tariq (CAN),2013-2019,15,15,16,12,4,12,0,3 (3ct 0st),1.0659999999999998,
14,JW Jenner (JER),2019-2019,17,17,16,16,0,0,16,4 (4ct 0st),0.941,
15,P Khadka (NEPAL),2014-2019,30,30,16,16,0,0,16,3 (3ct 0st),0.5329999999999999,
16,Nawroz Mangal (AFG),2010-2017,32,32,16,16,0,0,16,3 (3ct 0st),0.5,
17,AM Rahane (INDIA),2011-2016,20,20,16,16,0,0,16,4 (4ct 0st),0.8,
18,WB Rankin (ENG/IRE),2009-2019,48,47,16,16,0,0,16,2 (2ct 0st),0.34,
19,Rashid Khan (AFG/ICC),2015-2019,45,45,16,16,0,0,16,2 (2ct 0st),0.355,
20,Shafiqullah (AFG),2010-2019,46,46,16,14,2,1,13,3 (3ct 0st),0.34700000000000003,
21,Ahmed Shehzad (PAK),2009-2019,59,59,15,15,0,0,15,2 (2ct 0st),0.254,
22,Babar Azam (PAK),2016-2019,36,36,15,15,0,0,15,2 (2ct 0st),0.41600000000000004,
23,B Bhandari (NEPAL),2014-2019,27,27,15,10,5,7,3,3 (3ct 0st),0.555,
24,PD Collingwood (ENG/World),2005-2017,36,36,15,15,0,0,15,2 (2ct 0st),0.41600000000000004,
25,CH Gayle (WI),2006-2019,58,58,15,15,0,0,15,1 (1ct 0st),0.258,
26,Ghulam Shabber (UAE),2016-2019,17,17,15,14,1,14,0,2 (2ct 0st),0.882,
27,ZE Green (NAM),2019-2019,16,16,15,10,5,10,0,4 (3ct 1st),0.937,
28,Nasir Hossain (BDESH),2011-2016,31,30,15,15,0,0,15,2 (2ct 0st),0.5,
29,SW Poynter (IRE),2015-2019,25,23,15,13,2,8,5,2 (2ct 0st),0.652,
30,MS Wade (AUS),2011-2016,26,26,15,13,2,13,0,3 (2ct 1st),0.5760000000000001,
31,CAK Walton (WI),2014-2018,19,19,15,13,2,10,3,3 (3ct 0st),0.789,
32,SC Williams (ZIM),2006-2019,38,38,15,15,0,0,15,2 (2ct 0st),0.39399999999999996,
33,JJ Atkinson (HKG),2014-2016,13,13,14,14,0,14,0,3 (3ct 0st),1.0759999999999998,
34,A Balbirnie (IRE),2015-2019,37,35,14,14,0,0,14,2 (2ct 0st),0.4,
35,F Behardien (SA),2012-2018,38,38,14,14,0,0,14,2 (2ct 0st),0.368,
36,Fakhar Zaman (PAK),2017-2019,34,34,14,14,0,0,14,2 (2ct 0st),0.41100000000000003,
37,Imad Wasim (PAK),2015-2019,41,41,14,14,0,0,14,2 (2ct 0st),0.341,
38,IA Karim (KENYA),2013-2019,16,16,14,11,3,9,2,5 (2ct 3st),0.875,
39,G Malla (NEPAL),2014-2019,24,24,14,14,0,0,14,3 (3ct 0st),0.583,
40,Misbah-ul-Haq (PAK),2007-2012,39,39,14,14,0,0,14,2 (2ct 0st),0.358,
41,MP O'Dowd (NL),2015-2019,36,35,14,14,0,0,14,2 (2ct 0st),0.4,
42,KP Pietersen (ENG),2005-2013,37,36,14,14,0,0,14,3 (3ct 0st),0.38799999999999996,
43,MJ Santner (NZ),2015-2019,39,38,14,14,0,0,14,2 (2ct 0st),0.368,
44,A Vala (PNG),2015-2019,26,26,14,14,0,0,14,3 (3ct 0st),0.5379999999999999,
45,J Vira (VAN),2019-2019,14,14,14,10,4,10,0,3 (3ct 0st),1.0,
46,LJ Wright (ENG),2007-2014,51,50,14,14,0,0,14,2 (2ct 0st),0.28,
47,AC Agar (AUS),2016-2019,21,21,13,13,0,0,13,2 (2ct 0st),0.619,
48,Ahmed Raza (UAE),2014-2019,36,36,13,13,0,0,13,2 (2ct 0st),0.361,
49,Ahsan Malik (NL),2012-2017,31,30,13,13,0,0,13,2 (2ct 0st),0.433,
0,TC Bruce (NZ),2017-2019,15,14,13,13,0,1,12,3 (3ct 0st),0.9279999999999999,
1,MJ Clarke (AUS),2005-2010,34,34,13,13,0,0,13,2 (2ct 0st),0.382,
2,NM Coulter-Nile (AUS),2013-2019,28,27,13,13,0,0,13,2 (2ct 0st),0.48100000000000004,
3,JEC Franklin (NZ),2006-2013,38,38,13,13,0,0,13,2 (2ct 0st),0.342,
4,Liton Das (BDESH),2015-2019,25,25,13,13,0,0,13,2 (2ct 0st),0.52,
5,JF Mooney (IRE),2009-2015,27,27,13,13,0,0,13,2 (2ct 0st),0.48100000000000004,
6,MA Ouma (KENYA),2007-2013,22,22,13,8,5,8,0,2 (2ct 0st),0.59,
7,TD Paine (AUS/World),2009-2017,12,12,13,11,2,11,0,3 (3ct 0st),1.083,
8,SP Patil (UAE),2014-2016,18,18,13,9,4,9,0,2 (2ct 0st),0.722,
9,KL Rahul (INDIA),2016-2019,34,34,13,13,0,0,13,2 (2ct 0st),0.382,
10,Aamir Kaleem (OMAN),2015-2019,25,24,12,12,0,0,12,2 (2ct 0st),0.5,
11,TA Boult (NZ),2013-2019,27,27,12,12,0,0,12,3 (3ct 0st),0.444,
12,J Charles (WI),2011-2016,34,34,12,10,2,0,10,2 (2ct 0st),0.35200000000000004,
13,JH Davey (SCOT),2012-2019,21,20,12,12,0,0,12,2 (2ct 0st),0.6,
14,CR Ervine (ZIM),2010-2019,22,22,12,12,0,0,12,3 (3ct 0st),0.545,
15,HG Munsey (SCOT),2015-2019,38,36,12,12,0,0,12,3 (3ct 0st),0.33299999999999996,
16,Nadeem Ahmed (HKG),2014-2017,24,24,12,12,0,0,12,2 (2ct 0st),0.5,
17,JDP Oram (NZ),2005-2012,36,36,12,12,0,0,12,2 (2ct 0st),0.33299999999999996,
18,Saeed Ajmal (PAK),2009-2015,64,64,12,12,0,0,12,2 (2ct 0st),0.187,
19,MN Samuels (WI),2007-2018,67,67,12,12,0,0,12,2 (2ct 0st),0.179,
20,TL Seifert (NZ),2018-2019,19,19,12,8,4,8,0,2 (2ct 0st),0.631,
21,V Sibanda (ZIM),2007-2016,26,26,12,12,0,0,12,3 (3ct 0st),0.461,
22,Tamoor Sajjad (QAT),2019-2019,12,12,12,12,0,0,12,2 (2ct 0st),1.0,
23,HA Varaiya (KENYA),2007-2013,25,25,12,12,0,0,12,2 (2ct 0st),0.48,
24,DJ Willey (ENG),2015-2019,28,28,12,12,0,0,12,2 (2ct 0st),0.428,
25,Younis Khan (PAK),2006-2010,25,25,12,12,0,0,12,2 (2ct 0st),0.48,
26,Yuvraj Singh (INDIA),2007-2017,58,57,12,12,0,0,12,2 (2ct 0st),0.21,
27,A Bagai (CAN),2008-2013,9,9,11,5,6,5,0,2 (1ct 1st),1.222,
28,S Chandramohan (SGP),2019-2019,12,12,11,11,0,0,11,3 (3ct 0st),0.9159999999999999,
29,TH David (SGP),2019-2019,12,12,11,11,0,0,11,4 (4ct 0st),0.9159999999999999,
30,N Davin (NAM),2019-2019,16,16,11,11,0,0,11,3 (3ct 0st),0.687,
31,JSE Dunford (JER),2019-2019,17,17,11,6,5,6,0,1 (1ct 0st),0.647,
32,MG Erasmus (NAM),2019-2019,16,16,11,11,0,0,11,2 (2ct 0st),0.687,
33,JP Faulkner (AUS),2012-2017,24,24,11,11,0,0,11,2 (2ct 0st),0.45799999999999996,
34,G Gambhir (INDIA),2007-2012,37,36,11,11,0,0,11,2 (2ct 0st),0.305,
35,Imran Nazir (PAK),2007-2012,25,25,11,11,0,0,11,2 (2ct 0st),0.44,
36,Jatinder Singh (OMAN),2015-2019,25,25,11,11,0,0,11,2 (2ct 0st),0.44,
37,Khawar Ali (OMAN),2015-2019,29,28,11,11,0,0,11,2 (2ct 0st),0.392,
38,Mohammed Rizlan (QAT),2019-2019,15,15,11,8,3,8,0,3 (2ct 1st),0.733,
39,PL Mommsen (SCOT),2012-2016,24,22,11,11,0,0,11,2 (2ct 0st),0.5,
40,GD Phillips (NZ),2017-2018,11,10,11,9,2,7,2,4 (3ct 1st),1.1,
41,Rizwan Cheema (CAN),2008-2019,24,24,11,11,0,0,11,2 (2ct 0st),0.45799999999999996,
42,Rohan Mustafa (UAE),2014-2019,38,38,11,11,0,0,11,2 (2ct 0st),0.289,
43,AD Russell (WI),2011-2018,47,47,11,11,0,0,11,2 (2ct 0st),0.23399999999999999,
44,Shadab Khan (PAK),2017-2019,38,38,11,11,0,0,11,1 (1ct 0st),0.289,
45,Shaiman Anwar (UAE),2014-2019,32,32,11,11,0,0,11,2 (2ct 0st),0.34299999999999997,
46,DW Steyn (SA),2007-2019,44,44,11,11,0,0,11,1 (1ct 0st),0.25,
47,T Taibu (ZIM),2007-2012,17,17,11,6,5,6,0,3 (0ct 3st),0.647,
48,PA van Meekeren (NL),2013-2019,41,39,11,11,0,0,11,2 (2ct 0st),0.282,
49,D Weston (GER),2019-2019,6,6,11,9,2,9,0,4 (3ct 1st),1.8330000000000002,
0,Abdur Razzak (BDESH),2006-2014,34,33,10,10,0,0,10,2 (2ct 0st),0.303,
1,GJ Bailey (AUS/World),2012-2017,30,30,10,10,0,0,10,2 (2ct 0st),0.33299999999999996,
2,SJ Benn (WI),2008-2016,24,24,10,10,0,0,10,3 (3ct 0st),0.41600000000000004,
3,TT Bresnan (ENG),2006-2014,34,34,10,10,0,0,10,2 (2ct 0st),0.294,
4,RP Burl (ZIM),2018-2019,16,16,10,10,0,0,10,2 (2ct 0st),0.625,
5,SS Cottrell (WI),2014-2019,22,22,10,10,0,0,10,2 (2ct 0st),0.45399999999999996,
6,N Dickwella (SL),2016-2019,23,23,10,10,0,9,1,2 (2ct 0st),0.434,
7,R Escobar (Arg),2019-2019,5,5,10,7,3,7,0,3 (3ct 0st),2.0,
8,FJ Klaassen (NL),2018-2019,21,20,10,10,0,0,10,2 (2ct 0st),0.5,
9,Mashrafe Mortaza (BDESH),2006-2017,54,53,10,10,0,0,10,3 (3ct 0st),0.188,
10,Nizakat Khan (HKG),2014-2019,34,34,10,10,0,0,10,2 (2ct 0st),0.294,
11,JL Ontong (SA),2008-2015,14,14,10,10,0,0,10,3 (3ct 0st),0.7140000000000001,
12,RJ Peterson (SA),2006-2014,21,21,10,10,0,0,10,2 (2ct 0st),0.47600000000000003,
13,AU Rashid (ENG),2009-2019,40,40,10,10,0,0,10,2 (2ct 0st),0.25,
14,SM Sharif (SCOT),2012-2019,42,41,10,10,0,0,10,2 (2ct 0st),0.243,
15,JJ Smit (NAM),2019-2019,12,12,10,10,0,0,10,3 (3ct 0st),0.833,
16,LJ Tucker (IRE),2016-2019,14,14,10,10,0,2,8,2 (2ct 0st),0.7140000000000001,
17,Usman Ghani (AFG),2015-2019,19,19,10,10,0,0,10,2 (2ct 0st),0.526,
18,Asif Ali (PAK),2018-2019,25,25,9,9,0,0,9,1 (1ct 0st),0.36,
19,Mudassar Bukhari (NL),2008-2016,38,36,9,9,0,0,9,2 (2ct 0st),0.25,
20,CJ Chibhabha (ZIM),2006-2018,33,33,9,9,0,0,9,2 (2ct 0st),0.272,
21,MD Gunathilaka (SL),2016-2019,21,21,9,9,0,0,9,3 (3ct 0st),0.428,
22,DT Johnston (IRE),2008-2013,30,28,9,9,0,0,9,3 (3ct 0st),0.321,
23,Karan KC (NEPAL),2015-2019,25,25,9,9,0,0,9,2 (2ct 0st),0.36,
24,E Lewis (WI),2016-2019,29,29,9,9,0,0,9,2 (2ct 0st),0.31,
25,PD McGlashan (NZ),2006-2010,11,11,9,9,0,9,0,3 (3ct 0st),0.818,
26,Manpreet Singh (ITA),2019-2019,8,7,9,6,3,6,0,4 (3ct 1st),1.285,
27,Mohamed Azzam (Mald),2019-2019,7,7,9,8,1,8,0,3 (3ct 0st),1.285,
28,J Mubarak (SL),2007-2009,16,16,9,9,0,0,9,2 (2ct 0st),0.562,
29,Mustafizur Rahman (BDESH),2015-2019,37,37,9,9,0,0,9,3 (3ct 0st),0.243,
30,SO Ngoche (KENYA),2010-2019,28,28,9,9,0,0,9,2 (2ct 0st),0.321,
31,RR Pant (INDIA),2017-2019,26,26,9,6,3,4,2,2 (2ct 0st),0.34600000000000003,
32,YK Pathan (INDIA),2007-2012,22,22,9,9,0,0,9,2 (2ct 0st),0.409,
33,R Powell (WI),2017-2019,23,23,9,9,0,0,9,2 (2ct 0st),0.391,
34,MJ Prior (ENG),2007-2010,10,10,9,6,3,6,0,4 (4ct 0st),0.9,
35,DMW Rawlins (BMUDA),2019-2019,11,11,9,9,0,0,9,3 (3ct 0st),0.818,
36,JA Richardson (AUS),2017-2019,9,9,9,9,0,0,9,2 (2ct 0st),1.0,
37,RR Rossouw (SA),2014-2016,15,15,9,9,0,0,9,3 (3ct 0st),0.6,
38,CJO Smith (SCOT),2007-2009,8,7,9,5,4,5,0,2 (2ct 0st),1.285,
39,IS Sodhi (NZ),2014-2019,40,39,9,9,0,0,9,1 (1ct 0st),0.23,
40,MC Sorensen (IRE),2012-2016,26,24,9,9,0,0,9,2 (2ct 0st),0.375,
41,BA Stokes (ENG),2011-2018,23,22,9,9,0,0,9,3 (3ct 0st),0.409,
42,Sultan Ahmed (UAE),2017-2019,17,17,9,9,0,0,9,3 (3ct 0st),0.529,
43,Suraj Kumar (OMAN),2019-2019,13,13,9,7,2,7,0,2 (2ct 0st),0.6920000000000001,
44,JE Taylor (WI),2006-2018,30,30,9,9,0,0,9,1 (1ct 0st),0.3,
45,T van der Gugten (NL),2012-2019,39,38,9,9,0,0,9,2 (2ct 0st),0.23600000000000002,
46,DL Vettori (NZ),2007-2014,34,34,9,9,0,0,9,2 (2ct 0st),0.264,
47,CD Wallace (SCOT),2012-2019,19,18,9,7,2,6,1,2 (2ct 0st),0.5,
48,MN Waller (ZIM),2011-2018,32,32,9,9,0,0,9,1 (1ct 0st),0.281,
49,D Wiese (SA),2013-2016,20,20,9,9,0,0,9,2 (2ct 0st),0.45,
0,Zaheer Ibrahim (QAT),2019-2019,13,13,9,9,0,0,9,3 (3ct 0st),0.6920000000000001,
1,Aizaz Khan (HKG),2014-2019,30,30,8,8,0,0,8,2 (2ct 0st),0.266,
2,R Ashwin (INDIA),2010-2017,46,46,8,8,0,0,8,1 (1ct 0st),0.17300000000000001,
3,S Bau (PNG),2016-2019,23,23,8,8,0,0,8,3 (3ct 0st),0.34700000000000003,
4,DG Blampied (JER),2019-2019,17,17,8,8,0,0,8,2 (2ct 0st),0.47,
5,AC Botha (IRE),2008-2010,14,13,8,8,0,0,8,2 (2ct 0st),0.615,
6,JW Dernbach (ENG),2011-2014,34,33,8,8,0,0,8,2 (2ct 0st),0.242,
7,JN Frylinck (NAM),2019-2019,14,14,8,8,0,0,8,2 (2ct 0st),0.5710000000000001,
8,HH Gibbs (SA),2005-2010,23,23,8,8,0,0,8,3 (3ct 0st),0.34700000000000003,
9,RR Hendricks (SA),2014-2019,22,22,8,8,0,0,8,1 (1ct 0st),0.363,
10,H Klaasen (SA),2018-2019,9,9,8,8,0,5,3,2 (2ct 0st),0.888,
11,MJ Lumb (ENG),2010-2014,27,26,8,8,0,0,8,1 (1ct 0st),0.307,
12,BR McDermott (AUS),2018-2019,12,11,8,8,0,0,8,3 (3ct 0st),0.727,
13,Manpreet Singh (SGP),2019-2019,12,12,8,4,4,4,0,2 (1ct 1st),0.6659999999999999,
14,KD Mills (NZ),2005-2014,42,42,8,8,0,0,8,1 (1ct 0st),0.19,
15,DJ Mitchell (NZ),2019-2019,9,9,8,8,0,0,8,2 (2ct 0st),0.888,
16,Mohammad Nadeem (OMAN),2015-2019,22,22,8,8,0,0,8,3 (3ct 0st),0.363,
17,M Mosehle (SA),2017-2017,7,7,8,6,2,6,0,3 (2ct 1st),1.1420000000000001,
18,Nouman Sarwar (QAT),2019-2019,14,14,8,8,0,0,8,2 (2ct 0st),0.5710000000000001,
19,RT Ponting (AUS),2005-2009,17,17,8,8,0,0,8,2 (2ct 0st),0.47,
20,Rameez Shahzad (UAE),2016-2019,22,22,8,8,0,0,8,2 (2ct 0st),0.363,
21,Ravinderpal Singh (CAN),2019-2019,12,12,8,8,0,0,8,2 (2ct 0st),0.6659999999999999,
22,KW Richardson (AUS),2014-2019,15,15,8,8,0,0,8,2 (2ct 0st),0.5329999999999999,
23,DJM Short (AUS),2018-2019,20,19,8,8,0,0,8,2 (2ct 0st),0.42100000000000004,
24,DR Smith (WI),2006-2015,33,33,8,8,0,0,8,1 (1ct 0st),0.242,
25,Sompal Kami (NEPAL),2014-2019,28,28,8,8,0,0,8,2 (2ct 0st),0.285,
26,MA Starc (AUS),2012-2019,28,28,8,8,0,0,8,2 (2ct 0st),0.285,
27,SB Styris (NZ),2005-2010,31,31,8,8,0,0,8,2 (2ct 0st),0.258,
28,RML Taylor (SCOT),2013-2016,9,9,8,8,0,0,8,2 (2ct 0st),0.888,
29,HT Tector (IRE),2019-2019,14,14,8,8,0,0,8,2 (2ct 0st),0.5710000000000001,
30,HDRL Thirimanne (SL),2012-2016,26,26,8,8,0,0,8,1 (1ct 0st),0.307,
31,AJ Tye (AUS),2016-2018,26,25,8,8,0,0,8,2 (2ct 0st),0.32,
32,N Vanua (PNG),2015-2019,25,25,8,8,0,0,8,2 (2ct 0st),0.32,
33,MH Yardy (ENG),2006-2011,14,14,8,8,0,0,8,2 (2ct 0st),0.5710000000000001,
34,KJ Abbott (SA),2013-2016,21,21,7,7,0,0,7,2 (2ct 0st),0.33299999999999996,
35,RG Aga (KENYA),2008-2013,20,20,7,7,0,0,7,2 (2ct 0st),0.35,
36,MM Ali (ENG),2014-2018,25,25,7,7,0,0,7,2 (2ct 0st),0.28,
37,Aqib Ilyas (OMAN),2015-2019,22,22,7,7,0,0,7,2 (2ct 0st),0.318,
38,S Badree (WI/World),2012-2018,52,52,7,7,0,0,7,2 (2ct 0st),0.134,
39,HS Baidwan (CAN),2008-2013,17,17,7,7,0,0,7,2 (2ct 0st),0.41100000000000003,
40,RD Berrington (SCOT),2008-2019,61,59,7,7,0,0,7,2 (2ct 0st),0.11800000000000001,
41,Bilal Khan (OMAN),2015-2019,32,31,7,7,0,0,7,2 (2ct 0st),0.225,
42,RS Bopara (ENG),2008-2014,38,37,7,7,0,0,7,2 (2ct 0st),0.18899999999999997,
43,DAJ Bracewell (NZ),2011-2019,18,17,7,7,0,0,7,2 (2ct 0st),0.41100000000000003,
44,YS Chahal (INDIA),2016-2019,36,36,7,7,0,0,7,2 (2ct 0st),0.19399999999999998,
45,S Chanderpaul (WI),2006-2010,22,22,7,7,0,0,7,1 (1ct 0st),0.318,
46,MS Chapman (HKG/NZ),2014-2018,24,24,7,7,0,0,7,2 (2ct 0st),0.29100000000000004,
47,PJ Cummins (AUS),2011-2019,25,25,7,7,0,0,7,1 (1ct 0st),0.28,
48,AR Cusack (IRE),2008-2015,37,33,7,7,0,0,7,2 (2ct 0st),0.212,
49,Dawlat Zadran (AFG),2012-2019,34,34,7,7,0,0,7,2 (2ct 0st),0.205,
0,BR Dunk (AUS),2014-2017,5,5,7,5,2,4,1,3 (1ct 2st),1.4,
1,AC Evans (SCOT),2015-2019,27,25,7,7,0,0,7,1 (1ct 0st),0.28,
2,Faheem Ashraf (PAK),2017-2019,27,27,7,7,0,0,7,2 (2ct 0st),0.259,
3,Fawad Alam (PAK),2007-2010,24,24,7,7,0,0,7,2 (2ct 0st),0.29100000000000004,
4,Harbhajan Singh (INDIA),2006-2016,28,27,7,7,0,0,7,2 (2ct 0st),0.259,
5,Hasan Ali (PAK),2016-2019,30,30,7,7,0,0,7,1 (1ct 0st),0.233,
6,AW Hawkins-Kay (JER),2019-2019,16,16,7,7,0,0,7,2 (2ct 0st),0.43700000000000006,
7,JO Holder (WI),2014-2019,17,17,7,7,0,0,7,2 (2ct 0st),0.41100000000000003,
8,Imran Tahir (SA/World),2013-2019,38,38,7,7,0,0,7,2 (2ct 0st),0.184,
9,Iqbal Hussain (QAT),2019-2019,15,15,7,7,0,0,7,2 (2ct 0st),0.466,
10,JH Kallis (SA),2005-2012,25,25,7,7,0,0,7,2 (2ct 0st),0.28,
11,Kuldeep Yadav (INDIA),2017-2019,19,19,7,7,0,0,7,2 (2ct 0st),0.368,
12,MJ McClenaghan (ICC/NZ),2012-2018,29,29,7,7,0,0,7,1 (1ct 0st),0.24100000000000002,
13,MW Machan (SCOT),2013-2016,13,13,7,7,0,0,7,1 (1ct 0st),0.5379999999999999,
14,AD Mascarenhas (ENG),2007-2009,14,14,7,7,0,0,7,2 (2ct 0st),0.5,
15,Mehidy Hasan Miraz (BDESH),2017-2018,13,13,7,7,0,0,7,2 (2ct 0st),0.5379999999999999,
16,BMAJ Mendis (SL),2011-2018,22,22,7,7,0,0,7,2 (2ct 0st),0.318,
17,AK Mohan (Fin),2019-2019,5,5,7,5,2,3,2,3 (2ct 1st),1.4,
18,PJ Moor (ZIM),2016-2019,21,21,7,7,0,2,5,2 (2ct 0st),0.33299999999999996,
19,Mosaddek Hossain (BDESH),2016-2019,14,14,7,7,0,0,7,2 (2ct 0st),0.5,
20,K Motlhanka (Botsw),2019-2019,7,7,7,3,4,3,0,4 (2ct 2st),1.0,
21,SP Narine (WI),2012-2019,51,51,7,7,0,0,7,2 (2ct 0st),0.13699999999999998,
22,H Osinde (CAN),2008-2013,11,11,7,7,0,0,7,2 (2ct 0st),0.636,
23,MK Pandey (INDIA),2015-2019,32,32,7,7,0,0,7,2 (2ct 0st),0.218,
24,KH Pandya (INDIA),2018-2019,18,18,7,7,0,0,7,2 (2ct 0st),0.38799999999999996,
25,LE Plunkett (ENG),2006-2019,22,22,7,7,0,0,7,1 (1ct 0st),0.318,
26,N Pooran (WI),2016-2019,16,16,7,7,0,3,4,2 (2ct 0st),0.43700000000000006,
27,JD Ryder (NZ),2008-2014,22,22,7,7,0,0,7,2 (2ct 0st),0.318,
28,RR Sarwan (WI),2007-2010,18,18,7,7,0,0,7,1 (1ct 0st),0.38799999999999996,
29,MD Shanaka (SL),2015-2019,35,35,7,7,0,0,7,2 (2ct 0st),0.2,
30,Simi Singh (IRE),2018-2019,18,18,7,7,0,0,7,2 (2ct 0st),0.38799999999999996,
31,Sohail Tanvir (PAK),2007-2017,57,57,7,7,0,0,7,1 (1ct 0st),0.122,
32,MP Stoinis (AUS),2015-2019,19,18,7,7,0,0,7,1 (1ct 0st),0.38799999999999996,
33,MR Swart (NL),2012-2016,26,26,7,7,0,0,7,1 (1ct 0st),0.26899999999999996,
34,R Tari (VAN),2019-2019,14,14,7,7,0,0,7,2 (2ct 0st),0.5,
35,TP Ura (PNG),2015-2019,23,23,7,7,0,0,7,2 (2ct 0st),0.304,
36,Waqas Barkat (HKG),2014-2019,22,22,7,7,0,0,7,2 (2ct 0st),0.318,
37,MRJ Watt (SCOT),2015-2019,35,33,7,7,0,0,7,1 (1ct 0st),0.212,
38,KOK Williams (WI),2016-2019,24,24,7,7,0,0,7,1 (1ct 0st),0.29100000000000004,
39,Yasir Ali (ESP),2019-2019,9,9,7,7,0,0,7,2 (2ct 0st),0.777,
40,CA Young (IRE),2015-2019,26,25,7,7,0,0,7,2 (2ct 0st),0.28,
41,Abdur Rehman (PAK),2007-2013,8,8,6,6,0,0,6,2 (2ct 0st),0.75,
42,DS Airee (NEPAL),2018-2019,18,18,6,6,0,0,6,1 (1ct 0st),0.33299999999999996,
43,PS Airee (NEPAL),2015-2019,11,11,6,5,1,3,2,2 (2ct 0st),0.545,
44,Anshuman Rath (HKG),2015-2017,20,20,6,6,0,0,6,1 (1ct 0st),0.3,
45,Awais Ahmed (ESP),2019-2019,9,9,6,5,1,5,0,1 (1ct 0st),0.6659999999999999,
46,NW Bracken (AUS),2006-2009,19,19,6,6,0,0,6,1 (1ct 0st),0.315,
47,JJ Bumrah (INDIA),2016-2019,42,42,6,6,0,0,6,2 (2ct 0st),0.142,
48,PVD Chameera (SL),2015-2018,19,19,6,6,0,0,6,2 (2ct 0st),0.315,
49,TLW Cooper (NL),2012-2016,18,17,6,6,0,0,6,2 (2ct 0st),0.35200000000000004,
0,FA Cossa (Moz),2019-2019,6,5,6,6,0,0,6,3 (3ct 0st),1.2,
1,AG Cremer (ZIM),2008-2018,29,29,6,6,0,0,6,1 (1ct 0st),0.20600000000000002,
2,ST Finn (ENG),2011-2015,21,21,6,6,0,0,6,1 (1ct 0st),0.285,
3,JS Foster (ENG),2009-2009,5,5,6,3,3,3,0,2 (1ct 1st),1.2,
4,SO Hetmyer (WI),2018-2019,20,20,6,6,0,0,6,2 (2ct 0st),0.3,
5,SD Hope (WI),2017-2019,13,13,6,6,0,6,0,2 (2ct 0st),0.461,
6,GJ Hopkins (NZ),2007-2010,10,10,6,4,2,2,2,2 (2ct 0st),0.6,
7,Imran Ismail (Moz),2019-2019,7,6,6,6,0,5,1,2 (2ct 0st),1.0,
8,Janak Prakash (SGP),2019-2019,12,12,6,6,0,0,6,3 (3ct 0st),0.5,
9,Kamran Khan (QAT),2019-2019,14,14,6,6,0,0,6,2 (2ct 0st),0.428,
10,Karim Sadiq (AFG),2010-2018,36,36,6,6,0,0,6,1 (1ct 0st),0.166,
11,B Kumar (INDIA),2012-2019,43,43,6,6,0,0,6,1 (1ct 0st),0.139,
12,ND Laegsgaard (DEN),2019-2019,9,7,6,6,0,0,6,3 (3ct 0st),0.857,
13,TWM Latham (NZ),2012-2017,13,13,6,6,0,4,2,3 (3ct 0st),0.461,
14,B Lee (AUS),2005-2012,25,25,6,6,0,0,6,3 (3ct 0st),0.24,
15,AR McBrine (IRE),2014-2017,19,18,6,6,0,0,6,2 (2ct 0st),0.33299999999999996,
16,PK Matautaava (VAN),2019-2019,10,10,6,6,0,0,6,3 (3ct 0st),0.6,
17,BAW Mendis (SL),2008-2014,39,39,6,6,0,0,6,1 (1ct 0st),0.153,
18,BKG Mendis (SL),2016-2019,24,24,6,6,0,0,6,1 (1ct 0st),0.25,
19,Mohammad Nawaz (3) (PAK),2016-2018,16,16,6,6,0,0,6,1 (1ct 0st),0.375,
20,CH Morris (SA),2012-2019,23,23,6,6,0,0,6,2 (2ct 0st),0.26,
21,Muhammad Usman (UAE),2016-2019,34,34,6,6,0,0,6,1 (1ct 0st),0.17600000000000002,
22,Nasir Jamshed (PAK),2012-2013,18,18,6,6,0,0,6,2 (2ct 0st),0.33299999999999996,
23,AR Nurse (WI),2011-2019,13,13,6,6,0,0,6,2 (2ct 0st),0.461,
24,Nurul Hasan (BDESH),2016-2017,9,9,6,2,4,2,0,2 (0ct 2st),0.6659999999999999,
25,NN Odhiambo (KENYA),2007-2013,24,24,6,6,0,0,6,1 (1ct 0st),0.25,
26,HH Patel (MWI),2019-2019,7,7,6,6,0,0,6,2 (2ct 0st),0.857,
27,CW Perchard (JER),2019-2019,15,15,6,6,0,0,6,1 (1ct 0st),0.4,
28,BBJL Perera (ITA),2019-2019,8,7,6,6,0,0,6,3 (3ct 0st),0.857,
29,AL Phehlukwayo (SA),2017-2019,23,23,6,6,0,0,6,2 (2ct 0st),0.26,
30,Rehman Abdul (ITA),2019-2019,7,6,6,6,0,0,6,2 (2ct 0st),1.0,
31,S Samarawickrama (SL),2017-2019,7,7,6,4,2,3,1,2 (1ct 1st),0.857,
32,Shafraz Jaleel (Mald),2019-2019,4,4,6,4,2,4,0,3 (3ct 0st),1.5,
33,HAM Shah (DEN),2019-2019,9,7,6,6,0,0,6,3 (3ct 0st),0.857,
34,TAM Siriwardana (SL),2015-2017,22,22,6,6,0,0,6,2 (2ct 0st),0.272,
35,P Utseya (ZIM),2006-2015,35,35,6,6,0,0,6,1 (1ct 0st),0.171,
36,MN van Wyk (SA),2007-2015,8,8,6,5,1,3,2,1 (1ct 0st),0.75,
37,JNT Vare (PNG),2015-2017,8,8,6,4,2,4,0,3 (3ct 0st),0.75,
38,S Vesawkar (NEPAL),2014-2019,17,17,6,6,0,0,6,1 (1ct 0st),0.35200000000000004,
39,Virandeep Singh (MAL),2019-2019,12,12,6,6,0,0,6,2 (2ct 0st),0.5,
40,DF Watts (SCOT),2007-2012,11,10,6,6,0,0,6,3 (3ct 0st),0.6,
41,Zeeshan Maqsood (OMAN),2015-2019,29,28,6,6,0,0,6,2 (2ct 0st),0.214,
42,Aarif Sheikh (NEPAL),2018-2019,11,11,5,5,0,0,5,1 (1ct 0st),0.45399999999999996,
43,Adnan Ilyas (OMAN),2015-2016,12,11,5,5,0,0,5,3 (3ct 0st),0.45399999999999996,
44,KK Ahuja (Mex),2019-2019,8,8,5,2,3,1,1,2 (0ct 2st),0.625,
45,CJA Amini (PNG),2015-2019,23,23,5,5,0,0,5,1 (1ct 0st),0.217,
46,Anwar Ali (PAK),2008-2016,16,16,5,5,0,0,5,2 (2ct 0st),0.312,
47,Ariful Haque (BDESH),2018-2018,9,9,5,5,0,0,5,1 (1ct 0st),0.555,
48,SJ Baard (NAM),2019-2019,13,13,5,5,0,0,5,2 (2ct 0st),0.384,
49,O Bascome (BMUDA),2019-2019,11,11,5,4,1,2,2,2 (2ct 0st),0.45399999999999996,
0,PKD Chase (IRE),2018-2019,12,12,5,5,0,0,5,2 (2ct 0st),0.41600000000000004,
1,DT Christian (AUS),2010-2017,16,16,5,5,0,0,5,2 (2ct 0st),0.312,
2,BCJ Cutting (AUS/World),2013-2017,7,7,5,5,0,0,5,3 (3ct 0st),0.7140000000000001,
3,MD Dai (PNG),2015-2017,9,9,5,5,0,0,5,2 (2ct 0st),0.555,
4,A Dananjaya (SL),2012-2019,22,22,5,5,0,0,5,1 (1ct 0st),0.22699999999999998,
5,GJ Delany (IRE),2019-2019,17,17,5,5,0,0,5,2 (2ct 0st),0.294,
6,NS Dhaliwal (CAN),2019-2019,12,12,5,5,0,0,5,1 (1ct 0st),0.41600000000000004,
7,AC Douglas (BMUDA),2019-2019,10,10,5,5,0,0,5,3 (3ct 0st),0.5,
8,FH Edwards (WI),2007-2012,20,20,5,5,0,0,5,1 (1ct 0st),0.25,
9,Fahad Ali (),2019-2019,3,3,5,4,1,2,2,3 (2ct 1st),1.666,
10,Faisal Javed (QAT),2019-2019,15,15,5,5,0,0,5,1 (1ct 0st),0.33299999999999996,
11,LB Ferbrache (GUE),2019-2019,9,9,5,5,0,0,5,1 (1ct 0st),0.555,
12,A Flintoff (ENG),2005-2007,7,7,5,5,0,0,5,2 (2ct 0st),0.7140000000000001,
13,DM Gondaria (KENYA),2013-2019,11,11,5,5,0,0,5,1 (1ct 0st),0.45399999999999996,
14,NA Greenwood (JER),2019-2019,8,8,5,5,0,0,5,3 (3ct 0st),0.625,
15,DAS Gunaratne (SL),2016-2017,12,12,5,5,0,0,5,2 (2ct 0st),0.41600000000000004,
16,S Hallett (Peru),2019-2019,4,4,5,4,1,4,0,3 (3ct 0st),1.25,
17,Hilal Ahmad (CZK-R),2019-2019,7,7,5,5,0,5,0,3 (3ct 0st),0.7140000000000001,
18,BJ Hodge (AUS),2007-2014,15,15,5,5,0,0,5,1 (1ct 0st),0.33299999999999996,
19,Ibrahim Hassan (Mald),2019-2019,11,11,5,5,0,0,5,2 (2ct 0st),0.45399999999999996,
20,Jagjit Singh (Peru),2019-2019,4,4,5,5,0,0,5,3 (3ct 0st),1.25,
21,KM Jarvis (ZIM),2011-2019,22,22,5,5,0,0,5,1 (1ct 0st),0.22699999999999998,
22,MG Johnson (AUS),2007-2013,30,30,5,5,0,0,5,1 (1ct 0st),0.166,
23,EC Joyce (ENG/IRE),2006-2014,18,17,5,5,0,0,5,2 (2ct 0st),0.294,
24,Junaid Sheikh (NOR),2019-2019,5,5,5,5,0,0,5,2 (2ct 0st),1.0,
25,D Kansonkho (MWI),2019-2019,7,7,5,5,0,0,5,2 (2ct 0st),0.7140000000000001,
26,Karim Janat (AFG),2016-2019,21,21,5,5,0,0,5,2 (2ct 0st),0.23800000000000002,
27,SP Khakurel (NEPAL),2014-2015,8,8,5,2,3,2,0,2 (0ct 2st),0.625,
28,UT Khawaja (AUS),2016-2016,9,9,5,5,0,0,5,1 (1ct 0st),0.555,
29,JP Kotze (NAM),2019-2019,12,12,5,5,0,0,5,2 (2ct 0st),0.41600000000000004,
30,HG Kuhn (SA),2009-2017,7,7,5,5,0,4,1,3 (3ct 0st),0.7140000000000001,
31,NR Kumar (CAN),2012-2019,18,18,5,5,0,0,5,2 (2ct 0st),0.27699999999999997,
32,AV Lalcheta (OMAN),2015-2019,17,16,5,5,0,0,5,2 (2ct 0st),0.312,
33,JS Malhotra (USA),2019-2019,6,6,5,2,3,2,0,2 (0ct 2st),0.833,
34,A Mansale (VAN),2019-2019,14,14,5,5,0,0,5,2 (2ct 0st),0.35700000000000004,
35,T Maruma (ZIM),2008-2019,13,13,5,5,0,0,5,1 (1ct 0st),0.384,
36,S Matsikenyeri (ZIM),2006-2012,10,10,5,5,0,0,5,2 (2ct 0st),0.5,
37,SS McKechnie (HKG),2019-2019,10,10,5,4,1,4,0,2 (2ct 0st),0.5,
38,EJB Miles (JER),2019-2019,14,14,5,5,0,0,5,2 (2ct 0st),0.35700000000000004,
39,AF Milne (NZ),2010-2018,21,21,5,5,0,0,5,1 (1ct 0st),0.23800000000000002,
40,Mirwais Ashraf (AFG),2010-2016,25,25,5,5,0,0,5,1 (1ct 0st),0.2,
41,Mohammad Rizwan (PAK),2015-2019,16,16,5,3,2,3,0,2 (2ct 0st),0.312,
42,Mohammed Nadeem (QAT),2019-2019,15,15,5,5,0,0,5,2 (2ct 0st),0.33299999999999996,
43,M Morkel (SA/World),2007-2017,44,44,5,5,0,0,5,1 (1ct 0st),0.113,
44,CB Mpofu (ZIM),2008-2019,30,30,5,5,0,0,5,2 (2ct 0st),0.166,
45,Muhammad Tanveer (QAT),2019-2019,15,15,5,5,0,0,5,2 (2ct 0st),0.33299999999999996,
46,S Muniandy (MAL),2019-2019,15,14,5,5,0,0,5,3 (3ct 0st),0.35700000000000004,
47,C Munoz-Mills (ESP),2019-2019,9,9,5,5,0,0,5,2 (2ct 0st),0.555,
48,SJ Myburgh (NL),2012-2019,33,32,5,5,0,0,5,1 (1ct 0st),0.156,
49,JDS Neesham (NZ),2012-2019,18,18,5,5,0,0,5,2 (2ct 0st),0.27699999999999997,
0,R Nehonde (Botsw),2019-2019,7,7,5,5,0,0,5,3 (3ct 0st),0.7140000000000001,
1,OE Newey (GUE),2019-2019,7,7,5,4,1,4,0,2 (2ct 0st),0.7140000000000001,
2,RJ Nicol (NZ),2010-2013,21,21,5,5,0,0,5,2 (2ct 0st),0.23800000000000002,
3,NM Odhiambo (KENYA),2010-2019,16,16,5,5,0,0,5,2 (2ct 0st),0.312,
4,TM Odoyo (KENYA),2007-2013,11,11,5,5,0,0,5,2 (2ct 0st),0.45399999999999996,
5,CN Onwuzulike (NGA),2019-2019,9,9,5,5,0,0,5,3 (3ct 0st),0.555,
6,R Panchal (ESP),2019-2019,9,9,5,5,0,0,5,2 (2ct 0st),0.555,
7,WD Parnell (SA),2009-2017,40,40,5,5,0,0,5,1 (1ct 0st),0.125,
8,AR Patel (INDIA),2015-2018,11,11,5,5,0,0,5,2 (2ct 0st),0.45399999999999996,
9,MD Patel (USA),2019-2019,8,8,5,3,2,1,2,2 (1ct 1st),0.625,
10,NK Patel (USA),2019-2019,4,4,5,5,0,0,5,2 (2ct 0st),1.25,
11,Rahmanullah Gurbaz (AFG),2019-2019,7,7,5,4,1,4,0,2 (1ct 1st),0.7140000000000001,
12,J Rasu (VAN),2019-2019,13,13,5,5,0,0,5,1 (1ct 0st),0.384,
13,D Ravu (PNG),2019-2019,17,17,5,5,0,0,5,1 (1ct 0st),0.294,
14,JJ Roy (ENG),2014-2018,32,32,5,5,0,0,5,1 (1ct 0st),0.156,
15,Sami Sohail (MWI),2019-2019,7,7,5,5,0,0,5,2 (2ct 0st),0.7140000000000001,
16,Sandeep Goud (OMAN),2019-2019,12,12,5,5,0,0,5,2 (2ct 0st),0.41600000000000004,
17,E Schiferli (NL),2008-2010,7,6,5,5,0,0,5,1 (1ct 0st),0.833,
18,Shafiq Sharif (MAL),2019-2019,10,9,5,2,3,2,0,2 (2ct 0st),0.555,
19,KD Shah (HKG),2014-2019,26,26,5,5,0,0,5,2 (2ct 0st),0.192,
20,OA Shah (ENG),2007-2009,17,17,5,5,0,0,5,2 (2ct 0st),0.294,
21,Shapoor Zadran (AFG),2010-2018,34,34,5,5,0,0,5,1 (1ct 0st),0.147,
22,Sharjeel Khan (PAK),2013-2016,15,15,5,5,0,0,5,2 (2ct 0st),0.33299999999999996,
23,RJ Sidebottom (ENG),2007-2010,18,18,5,5,0,0,5,2 (2ct 0st),0.27699999999999997,
24,LPC Silva (SL),2006-2011,16,16,5,5,0,0,5,1 (1ct 0st),0.312,
25,TB Sole (SCOT),2019-2019,9,9,5,5,0,0,5,1 (1ct 0st),0.555,
26,GP Swann (ENG),2008-2012,39,39,5,5,0,0,5,1 (1ct 0st),0.128,
27,SR Taylor (USA),2019-2019,8,8,5,5,0,0,5,2 (2ct 0st),0.625,
28,SO Tikolo (KENYA),2007-2013,15,15,5,5,0,0,5,2 (2ct 0st),0.33299999999999996,
29,AJ Turner (AUS),2017-2019,11,11,5,5,0,0,5,1 (1ct 0st),0.45399999999999996,
30,C Viljoen (NAM),2019-2019,12,12,5,5,0,0,5,1 (1ct 0st),0.41600000000000004,
31,JM Vince (ENG),2015-2019,12,12,5,5,0,0,5,2 (2ct 0st),0.41600000000000004,
32,Wahab Riaz (PAK),2008-2019,31,31,5,5,0,0,5,1 (1ct 0st),0.161,
33,B Ward (JER),2019-2019,13,13,5,5,0,0,5,1 (1ct 0st),0.384,
34,Washington Sundar (INDIA),2017-2019,18,18,5,5,0,0,5,1 (1ct 0st),0.27699999999999997,
35,Abdul-Shakoor Rahimzei (GER),2019-2019,7,7,4,4,0,0,4,2 (2ct 0st),0.5710000000000001,
36,CN Ackermann (NL),2019-2019,11,11,4,4,0,0,4,1 (1ct 0st),0.363,
37,Adnan Idrees (KUW),2019-2019,6,6,4,4,0,0,4,1 (1ct 0st),0.6659999999999999,
38,Aftab Ahmed (BDESH),2006-2010,11,11,4,4,0,0,4,2 (2ct 0st),0.363,
39,FA Allen (WI),2018-2019,11,11,4,4,0,0,4,2 (2ct 0st),0.363,
40,Amjad Javed (UAE),2014-2017,22,22,4,4,0,0,4,1 (1ct 0st),0.18100000000000002,
41,SE Aquilina (MALTA),2019-2019,4,4,4,0,4,0,0,2 (0ct 2st),1.0,
42,Asad Mohammad (GER),2019-2019,9,9,4,4,0,0,4,1 (1ct 0st),0.444,
43,MA Baig (MWI),2019-2019,7,7,4,4,0,0,4,3 (3ct 0st),0.5710000000000001,
44,B Banerjee (Mex),2019-2019,6,6,4,4,0,3,1,1 (1ct 0st),0.6659999999999999,
45,T Banton (ENG),2019-2019,3,3,4,4,0,0,4,2 (2ct 0st),1.3330000000000002,
46,JP Behrendorff (AUS),2017-2019,7,6,4,4,0,0,4,3 (3ct 0st),0.6659999999999999,
47,IR Bell (ENG),2006-2014,8,8,4,4,0,0,4,1 (1ct 0st),0.5,
48,TS Bharaj (DEN),2019-2019,9,7,4,4,0,0,4,3 (3ct 0st),0.5710000000000001,
49,Meet Bhavsar (KUW),2019-2019,9,9,4,4,0,4,0,3 (3ct 0st),0.444,
0,MP Biddappa (PHI),2019-2019,4,4,4,3,1,3,0,2 (2ct 0st),1.0,
1,Bilal Tahir (KUW),2019-2019,4,4,4,4,0,0,4,1 (1ct 0st),1.0,
2,Bilal Zalmai (Aut),2019-2019,5,5,4,3,1,0,3,2 (2ct 0st),0.8,
3,PRP Boissevain (NL),2019-2019,4,4,4,4,0,0,4,2 (2ct 0st),1.0,
4,SE Bond (NZ),2005-2010,20,20,4,4,0,0,4,1 (1ct 0st),0.2,
5,DM Bravo (WI),2010-2019,20,20,4,4,0,0,4,2 (2ct 0st),0.2,
6,NT Broom (NZ),2009-2017,11,11,4,4,0,0,4,1 (1ct 0st),0.363,
7,DE Budge (SCOT),2018-2018,6,6,4,4,0,0,4,1 (1ct 0st),0.6659999999999999,
8,RW Chakabva (ZIM),2008-2019,12,12,4,4,0,0,4,1 (1ct 0st),0.33299999999999996,
9,TL Chatara (ZIM),2010-2019,21,21,4,4,0,0,4,1 (1ct 0st),0.19,
10,JW Chilia (VAN),2019-2019,14,14,4,4,0,0,4,2 (2ct 0st),0.285,
11,K Christie (HKG),2019-2019,11,11,4,4,0,0,4,1 (1ct 0st),0.363,
12,SR Clark (AUS),2006-2007,9,9,4,4,0,0,4,1 (1ct 0st),0.444,
13,DDP D'Silva (UAE),2019-2019,10,10,4,4,0,0,4,1 (1ct 0st),0.4,
14,DAP Darrell (BMUDA),2019-2019,11,11,4,4,0,0,4,2 (2ct 0st),0.363,
15,TN de Grooth (NL),2008-2013,15,14,4,4,0,0,4,2 (2ct 0st),0.285,
16,DM de Silva (SL),2015-2019,13,13,4,4,0,0,4,1 (1ct 0st),0.307,
17,PWH de Silva (SL),2019-2019,8,8,4,4,0,0,4,1 (1ct 0st),0.5,
18,S Dhaniram (CAN),2008-2010,11,11,4,4,0,0,4,2 (2ct 0st),0.363,
19,S Dube (INDIA),2019-2019,6,6,4,4,0,0,4,2 (2ct 0st),0.6659999999999999,
20,Ehsan Khan (HKG),2016-2019,15,15,4,4,0,0,4,1 (1ct 0st),0.266,
21,Elias Sunny (BDESH),2012-2012,7,7,4,4,0,0,4,3 (3ct 0st),0.5710000000000001,
22,GD Elliott (NZ/World),2009-2017,17,17,4,4,0,0,4,2 (2ct 0st),0.235,
23,Fahad Tariq (UAE),2016-2016,6,6,4,4,0,0,4,3 (3ct 0st),0.6659999999999999,
24,Farhad Reza (BDESH),2006-2014,13,13,4,4,0,0,4,1 (1ct 0st),0.307,
25,O Fournier (CRC),2019-2019,2,2,4,4,0,0,4,2 (2ct 0st),2.0,
26,PG Fulton (NZ),2006-2012,12,12,4,4,0,0,4,1 (1ct 0st),0.33299999999999996,
27,PF Gallagher (Fin),2019-2019,3,3,4,4,0,0,4,2 (2ct 0st),1.3330000000000002,
28,G Goudie (SCOT),2010-2013,9,9,4,4,0,0,4,1 (1ct 0st),0.444,
29,TGJ Gruijters (NL),2012-2013,8,8,4,4,0,0,4,2 (2ct 0st),0.5,
30,K Gupta (Chile),2019-2019,4,4,4,3,1,3,0,3 (2ct 1st),1.0,
31,OD Hald (DEN),2019-2019,9,7,4,4,0,0,4,2 (2ct 0st),0.5710000000000001,
32,Hamza Tahir (SCOT),2018-2019,11,11,4,4,0,0,4,1 (1ct 0st),0.363,
33,RM Haq (SCOT),2007-2013,21,20,4,4,0,0,4,2 (2ct 0st),0.2,
34,TM Head (AUS),2016-2018,16,16,4,4,0,0,4,1 (1ct 0st),0.25,
35,R Hekure (PNG),2019-2019,8,8,4,4,0,0,4,2 (2ct 0st),0.5,
36,DR Hooper (GUE),2019-2019,9,9,4,4,0,0,4,2 (2ct 0st),0.444,
37,Hussain Talat (PAK),2018-2019,14,14,4,4,0,0,4,3 (3ct 0st),0.285,
38,DP Hyatt (WI),2011-2012,5,5,4,4,0,0,4,1 (1ct 0st),0.8,
39,Imran Haider (ROM),2019-2019,2,2,4,2,2,2,0,3 (2ct 1st),2.0,
40,Imrul Kayes (BDESH),2010-2017,14,14,4,4,0,0,4,1 (1ct 0st),0.285,
41,SS Iyer (INDIA),2017-2019,14,14,4,4,0,0,4,1 (1ct 0st),0.285,
42,ST Jayasuriya (SL),2006-2011,31,31,4,4,0,0,4,1 (1ct 0st),0.129,
43,LM Jongwe (ZIM),2015-2016,8,8,4,4,0,0,4,2 (2ct 0st),0.5,
44,SHT Kandamby (SL),2008-2011,5,5,4,4,0,0,4,2 (2ct 0st),0.8,
45,G Kansonkho (MWI),2019-2019,6,6,4,4,0,0,4,2 (2ct 0st),0.6659999999999999,
46,AN Kervezee (NL),2009-2012,10,10,4,4,0,0,4,2 (2ct 0st),0.4,
47,Khalid Latif (PAK),2008-2016,13,13,4,4,0,0,4,1 (1ct 0st),0.307,
48,BA King (WI),2019-2019,6,6,4,4,0,0,4,1 (1ct 0st),0.6659999999999999,
49,EB Knowles (CZK-R),2019-2019,7,7,4,4,0,0,4,4 (4ct 0st),0.5710000000000001,
0,SC Kuggeleijn (NZ),2019-2019,9,9,4,4,0,0,4,2 (2ct 0st),0.444,
1,Kuldeep Lal (ESP),2019-2019,8,8,4,4,0,0,4,2 (2ct 0st),0.5,
2,RE Levi (SA),2012-2012,13,13,4,4,0,0,4,1 (1ct 0st),0.307,
3,N Madziva (ZIM),2015-2019,15,15,4,4,0,0,4,1 (1ct 0st),0.266,
4,MSS Mandy (Chile),2019-2019,4,4,4,4,0,0,4,1 (1ct 0st),1.0,
5,MR Marsh (AUS),2011-2018,11,11,4,4,0,0,4,2 (2ct 0st),0.363,
6,XM Marshall (USA/WI),2008-2019,13,13,4,4,0,0,4,1 (1ct 0st),0.307,
7,WP Masakadza (ZIM),2015-2019,12,12,4,4,0,0,4,2 (2ct 0st),0.33299999999999996,
8,Md Nurul Huda (Fin),2019-2019,5,5,4,4,0,0,4,2 (2ct 0st),0.8,
9,AS Mehmi (),2019-2019,3,3,4,4,0,0,4,2 (2ct 0st),1.3330000000000002,
10,Mohammad Amir (PAK),2009-2019,48,48,4,4,0,0,4,1 (1ct 0st),0.083,
11,Mohammad Ashraful (BDESH),2007-2013,23,23,4,4,0,0,4,1 (1ct 0st),0.17300000000000001,
12,Mohammad Boota (UAE),2019-2019,16,16,4,3,1,2,1,2 (1ct 1st),0.25,
13,Mohammad Naveed (UAE),2015-2019,31,31,4,4,0,0,4,1 (1ct 0st),0.129,
14,Muhammad Awais (),2019-2019,3,3,4,3,1,3,0,3 (2ct 1st),1.3330000000000002,
15,GRD Munasinghe (ITA),2019-2019,8,7,4,4,0,0,4,1 (1ct 0st),0.5710000000000001,
16,A Nehra (INDIA),2009-2017,27,27,4,4,0,0,4,1 (1ct 0st),0.14800000000000002,
17,A Neill (SCOT),2019-2019,5,5,4,4,0,0,4,2 (2ct 0st),0.8,
18,SN Netravalkar (USA),2019-2019,8,8,4,4,0,0,4,1 (1ct 0st),0.5,
19,N Nipiko (VAN),2019-2019,14,14,4,4,0,0,4,1 (1ct 0st),0.285,
20,Noor Ali Zadran (AFG),2010-2017,20,20,4,4,0,0,4,1 (1ct 0st),0.2,
21,AA Obanda (KENYA),2007-2019,30,30,4,4,0,0,4,1 (1ct 0st),0.133,
22,JS Patel (NZ),2005-2008,11,11,4,4,0,0,4,1 (1ct 0st),0.363,
23,RK Paudel (NEPAL),2019-2019,11,11,4,4,0,0,4,2 (2ct 0st),0.363,
24,N Pokana (PNG),2016-2019,19,19,4,4,0,0,4,2 (2ct 0st),0.21,
25,S Prasanna (SL),2013-2017,20,20,4,4,0,0,4,2 (2ct 0st),0.2,
26,AT Rayudu (INDIA),2014-2016,6,6,4,4,0,0,4,2 (2ct 0st),0.6659999999999999,
27,B Regmi (NEPAL),2014-2019,18,18,4,4,0,0,4,1 (1ct 0st),0.222,
28,MJ Richardson (GER),2019-2019,3,3,4,1,3,1,0,2 (1ct 1st),1.3330000000000002,
29,MJG Rippon (NL),2013-2018,18,17,4,4,0,0,4,1 (1ct 0st),0.235,
30,PADLR Sandakan (SL),2017-2019,14,14,4,4,0,0,4,1 (1ct 0st),0.285,
31,Saqlain Haider (UAE),2016-2016,6,6,4,4,0,0,4,2 (2ct 0st),0.6659999999999999,
32,T Shamsi (SA),2017-2019,16,16,4,4,0,0,4,1 (1ct 0st),0.25,
33,I Sharma (INDIA),2008-2013,14,14,4,4,0,0,4,1 (1ct 0st),0.285,
34,B Shikongo (NAM),2019-2019,11,11,4,4,0,0,4,1 (1ct 0st),0.363,
35,Sikander Zulfiqar (NL),2016-2019,11,11,4,4,0,0,4,2 (2ct 0st),0.363,
36,Simandeep Singh (HKG),2019-2019,7,7,4,4,0,0,4,2 (2ct 0st),0.5710000000000001,
37,Sohaib Maqsood (PAK),2013-2016,20,20,4,4,0,0,4,1 (1ct 0st),0.2,
38,ES Szwarczynski (NL),2008-2013,14,13,4,4,0,0,4,2 (2ct 0st),0.307,
39,Tanwir Afzal (HKG),2014-2016,21,21,4,4,0,0,4,1 (1ct 0st),0.19,
40,RN ten Doeschate (NL),2008-2019,22,21,4,4,0,0,4,1 (1ct 0st),0.19,
41,C Tommy (VAN),2019-2019,12,12,4,4,0,0,4,1 (1ct 0st),0.33299999999999996,
42,I Udana (SL),2009-2019,27,27,4,4,0,0,4,2 (2ct 0st),0.14800000000000002,
43,Umar Amin (PAK),2013-2018,14,14,4,4,0,0,4,1 (1ct 0st),0.285,
44,DLS van Bunge (NL),2008-2013,14,13,4,4,0,0,4,2 (2ct 0st),0.307,
45,RR Watson (SCOT),2007-2010,10,9,4,4,0,0,4,2 (2ct 0st),0.444,
46,K Weeraratne (SL),2008-2009,5,5,4,4,0,0,4,2 (2ct 0st),0.8,
47,Yasir Shah (PAK),2011-2011,2,2,4,4,0,0,4,3 (3ct 0st),2.0,
48,Ziaur Rahman (BDESH),2012-2014,14,14,4,4,0,0,4,2 (2ct 0st),0.285,
49,MR Adair (IRE),2019-2019,17,17,3,3,0,0,3,1 (1ct 0st),0.17600000000000002,
0,S Adedeji (NGA),2019-2019,6,6,3,3,0,0,3,1 (1ct 0st),0.5,
1,Afif Hossain (BDESH),2018-2019,8,8,3,3,0,0,3,1 (1ct 0st),0.375,
2,Aftab Alam (AFG),2012-2018,12,12,3,3,0,0,3,2 (2ct 0st),0.25,
3,KK Ahmed (INDIA),2018-2019,14,14,3,3,0,0,3,1 (1ct 0st),0.214,
4,Ainool Haqqiem (MAL),2019-2019,4,4,3,1,2,1,0,2 (0ct 2st),0.75,
5,TP Allen (USA),2019-2019,5,5,3,3,0,0,3,1 (1ct 0st),0.6,
6,Al-Amin Hossain (BDESH),2013-2019,28,26,3,3,0,0,3,1 (1ct 0st),0.115,
7,Amir Mangal (GER),2019-2019,9,9,3,3,0,0,3,2 (2ct 0st),0.33299999999999996,
8,JM Anderson (ENG),2007-2009,19,19,3,3,0,0,3,1 (1ct 0st),0.157,
9,Anowarul Islam (THAI),2019-2019,4,4,3,3,0,0,3,2 (2ct 0st),0.75,
10,P Arrighi (Arg),2019-2019,5,5,3,3,0,0,3,2 (2ct 0st),0.6,
11,Asad Shafiq (PAK),2010-2012,10,10,3,3,0,0,3,1 (1ct 0st),0.3,
12,NJ Astle (NZ),2005-2006,4,4,3,3,0,0,3,2 (2ct 0st),0.75,
13,TD Astle (NZ),2016-2019,3,3,3,3,0,0,3,1 (1ct 0st),1.0,
14,AJ Ayannaike (NGA),2019-2019,3,3,3,2,1,2,0,3 (2ct 1st),1.0,
15,F Baaleri (Ghana),2019-2019,4,4,3,3,0,1,2,2 (2ct 0st),0.75,
16,Babar Ali (BAH),2019-2019,3,3,3,3,0,0,3,1 (1ct 0st),1.0,
17,V Balakrishnan (Botsw),2019-2019,3,3,3,3,0,0,3,3 (3ct 0st),1.0,
18,OGL Bascome (BMUDA),2019-2019,11,11,3,3,0,0,3,1 (1ct 0st),0.272,
19,V Baskaran (SGP),2019-2019,12,12,3,3,0,0,3,1 (1ct 0st),0.25,
20,C Bisson (JER),2019-2019,14,14,3,3,0,0,3,1 (1ct 0st),0.214,
21,A Bohara (NEPAL),2019-2019,17,17,3,3,0,0,3,1 (1ct 0st),0.17600000000000002,
22,DG Brownlie (NZ),2010-2014,5,5,3,3,0,0,3,1 (1ct 0st),0.6,
23,IG Butler (NZ),2009-2013,19,19,3,3,0,0,3,1 (1ct 0st),0.157,
24,J Butler (GUE),2019-2019,9,9,3,3,0,0,3,1 (1ct 0st),0.33299999999999996,
25,C Carter (HKG),2015-2017,10,10,3,2,1,2,0,1 (1ct 0st),0.3,
26,C Chete (MWI),2019-2019,2,2,3,3,0,3,0,2 (2ct 0st),1.5,
27,LA Collado (GIBR),2019-2019,4,4,3,2,1,2,0,1 (1ct 0st),0.75,
28,PC Connell (IRE),2008-2010,9,8,3,3,0,0,3,1 (1ct 0st),0.375,
29,TK Curran (ENG),2017-2019,15,15,3,3,0,0,3,1 (1ct 0st),0.2,
30,CJ Dala (SA),2018-2019,9,9,3,3,0,0,3,1 (1ct 0st),0.33299999999999996,
31,SM Davies (ENG),2009-2011,5,5,3,2,1,2,0,2 (2ct 0st),0.6,
32,CD de Lange (SCOT),2015-2017,8,7,3,3,0,0,3,1 (1ct 0st),0.428,
33,Delawar Khan (DEN),2019-2019,9,7,3,3,0,0,3,2 (2ct 0st),0.428,
34,BFW de Leede (NL),2018-2019,8,8,3,3,0,0,3,1 (1ct 0st),0.375,
35,JL Denly (ENG),2009-2019,10,10,3,3,0,0,3,1 (1ct 0st),0.3,
36,N Dutta (CAN),2019-2019,11,11,3,3,0,0,3,2 (2ct 0st),0.272,
37,LH Ferguson (NZ),2017-2019,8,8,3,3,0,0,3,2 (2ct 0st),0.375,
38,CRD Fernando (SL),2006-2016,18,18,3,3,0,0,3,1 (1ct 0st),0.166,
39,Fiaz Ahmed (BAH),2019-2019,4,4,3,3,0,0,3,2 (2ct 0st),0.75,
40,Fitri Sham (MAL),2019-2019,15,14,3,3,0,0,3,1 (1ct 0st),0.214,
41,SC Getkate (IRE),2019-2019,14,14,3,3,0,0,3,2 (2ct 0st),0.214,
42,D Gim (NGA),2019-2019,6,6,3,3,0,0,3,2 (2ct 0st),0.5,
43,BD Glover (NL),2019-2019,19,19,3,3,0,0,3,1 (1ct 0st),0.157,
44,LF Goncalves (),2019-2019,3,3,3,1,2,1,0,2 (1ct 1st),1.0,
45,Z Groenewald (NAM),2019-2019,10,10,3,3,0,0,3,1 (1ct 0st),0.3,
46,GM Hamilton (SCOT),2007-2010,12,11,3,3,0,0,3,2 (2ct 0st),0.272,
47,Haris Sohail (PAK),2013-2019,14,14,3,3,0,0,3,2 (2ct 0st),0.214,
48,BE Hendricks (SA),2014-2019,11,11,3,3,0,0,3,2 (2ct 0st),0.272,
49,MC Henriques (AUS),2009-2017,11,11,3,3,0,0,3,1 (1ct 0st),0.272,
0,JR Hopes (AUS),2005-2010,12,12,3,3,0,0,3,1 (1ct 0st),0.25,
1,Ibrarul Haq (Saudi),2019-2019,5,5,3,3,0,0,3,3 (3ct 0st),0.6,
2,Imran Farhat (PAK),2010-2011,7,7,3,3,0,0,3,1 (1ct 0st),0.428,
3,Imran Khan (1) (PAK),2015-2015,3,3,3,3,0,0,3,2 (2ct 0st),1.0,
4,Inam-ul-Haq (QAT),2019-2019,11,11,3,3,0,0,3,1 (1ct 0st),0.272,
5,MM Iqbal (SCOT),2012-2013,6,6,3,3,0,0,3,1 (1ct 0st),0.5,
6,Izatullah Dawlatzai (AFG/GER),2012-2019,14,14,3,3,0,0,3,2 (2ct 0st),0.214,
7,Jahurul Islam (BDESH),2010-2013,3,3,3,3,0,0,3,1 (1ct 0st),1.0,
8,GSNFG Jayasuriya (SL),2015-2019,16,16,3,3,0,0,3,1 (1ct 0st),0.187,
9,S Jora (NEPAL),2019-2019,6,6,3,3,0,0,3,1 (1ct 0st),0.5,
10,I Katzarski (),2019-2019,3,3,3,3,0,0,3,2 (2ct 0st),1.0,
11,S Kaveri (Mex),2019-2019,7,7,3,3,0,0,3,2 (2ct 0st),0.428,
12,JM Kemp (SA),2005-2007,8,8,3,3,0,0,3,1 (1ct 0st),0.375,
13,Khurram Nawaz (OMAN),2017-2019,18,18,3,3,0,0,3,1 (1ct 0st),0.166,
14,J Kila (PNG),2019-2019,12,12,3,3,0,0,3,2 (2ct 0st),0.25,
15,AK Kitchen (NZ),2017-2018,5,4,3,3,0,0,3,2 (2ct 0st),0.75,
16,RAS Lakmal (SL),2011-2019,11,11,3,3,0,0,3,1 (1ct 0st),0.272,
17,S Lamichhane (ICC/NEPAL),2018-2019,18,18,3,3,0,0,3,1 (1ct 0st),0.166,
18,KS Leverock (BMUDA),2019-2019,12,12,3,3,0,0,3,1 (1ct 0st),0.25,
19,CA Lynn (AUS),2014-2018,18,17,3,3,0,0,3,1 (1ct 0st),0.17600000000000002,
20,WK McCallan (IRE),2008-2009,9,8,3,3,0,0,3,1 (1ct 0st),0.375,
21,R McLaren (SA),2009-2014,12,12,3,3,0,0,3,1 (1ct 0st),0.25,
22,CD McMillan (NZ),2005-2007,8,8,3,3,0,0,3,2 (2ct 0st),0.375,
23,WJ Malinda (Mald),2019-2019,3,3,3,3,0,0,3,2 (2ct 0st),1.0,
24,SE Marsh (AUS),2008-2016,15,15,3,3,0,0,3,2 (2ct 0st),0.2,
25,RD McCann (IRE),2012-2012,3,3,3,1,2,1,0,2 (0ct 2st),1.0,
26,Md Shafiqul Haque (THAI),2019-2019,4,4,3,1,2,1,0,1 (1ct 0st),0.75,
27,GP Meade (ITA),2019-2019,8,7,3,3,0,0,3,1 (1ct 0st),0.428,
28,Mehran Khan (OMAN),2015-2019,19,18,3,3,0,0,3,1 (1ct 0st),0.166,
29,T Mishra (KENYA),2007-2013,15,15,3,3,0,0,3,1 (1ct 0st),0.2,
30,Mohamed Rishwan (Mald),2019-2019,11,11,3,3,0,0,3,1 (1ct 0st),0.272,
31,Mohammad Asif (PAK),2006-2010,11,11,3,3,0,0,3,1 (1ct 0st),0.272,
32,Mohammad Mithun (BDESH),2014-2019,14,12,3,3,0,0,3,2 (2ct 0st),0.25,
33,Mohammad Saifuddin (BDESH),2017-2019,13,13,3,3,0,0,3,1 (1ct 0st),0.23,
34,Mohammad Sami (PAK),2010-2016,13,13,3,3,0,0,3,1 (1ct 0st),0.23,
35,JM Muirhead (AUS),2014-2014,5,5,3,3,0,0,3,1 (1ct 0st),0.6,
36,Mujeeb Ur Rahman (AFG),2018-2019,16,16,3,3,0,0,3,1 (1ct 0st),0.187,
37,AA Mulla (CAN),2008-2008,4,4,3,1,2,1,0,1 (1ct 0st),0.75,
38,T Munyonga (ZIM),2019-2019,5,5,3,3,0,0,3,2 (2ct 0st),0.6,
39,TJ Murtagh (IRE),2012-2016,14,14,3,3,0,0,3,1 (1ct 0st),0.214,
40,Najeeb Tarakai (AFG),2014-2019,12,12,3,3,0,0,3,2 (2ct 0st),0.25,
41,M Nasim Baras (AFG),2015-2015,3,3,3,3,0,0,3,2 (2ct 0st),1.0,
42,A Ndlovu (ZIM),2019-2019,3,3,3,3,0,0,3,2 (2ct 0st),1.0,
43,PM Nevill (AUS),2016-2016,9,9,3,2,1,2,0,1 (1ct 0st),0.33299999999999996,
44,DO Obuya (KENYA),2007-2012,10,10,3,2,1,1,1,1 (1ct 0st),0.3,
45,H Patel (CAN),2010-2013,11,11,3,3,0,0,3,1 (1ct 0st),0.272,
46,SR Patel (ENG),2011-2013,18,18,3,3,0,0,3,1 (1ct 0st),0.166,
47,JL Pattinson (AUS),2011-2012,4,4,3,3,0,0,3,2 (2ct 0st),0.75,
48,Pavandeep Singh (MAL),2019-2019,10,10,3,3,0,0,3,2 (2ct 0st),0.3,
49,RW Price (ZIM),2008-2012,16,16,3,3,0,0,3,1 (1ct 0st),0.187,
0,S Qeshile (SA),2019-2019,2,2,3,3,0,3,0,2 (2ct 0st),1.5,
1,K Rabada (SA),2014-2019,21,21,3,3,0,0,3,1 (1ct 0st),0.142,
2,LN Rajbanshi (NEPAL),2018-2019,12,12,3,3,0,0,3,1 (1ct 0st),0.25,
3,Aminuddin Ramly (MAL),2019-2019,10,9,3,3,0,0,3,2 (2ct 0st),0.33299999999999996,
4,S Ravikumar (CRC),2019-2019,3,3,3,3,0,0,3,2 (2ct 0st),1.0,
5,AJ Redmond (NZ),2009-2010,7,7,3,3,0,0,3,2 (2ct 0st),0.428,
6,KA Reynolds (Blz),2019-2019,3,3,3,3,0,0,3,2 (2ct 0st),1.0,
7,MJ Ross (ITA),2019-2019,8,7,3,3,0,0,3,2 (2ct 0st),0.428,
8,Saad Bin Zafar (CAN),2019-2019,11,11,3,3,0,0,3,1 (1ct 0st),0.272,
9,Sajid Cheema (Saudi),2019-2019,5,5,3,3,0,0,3,1 (1ct 0st),0.6,
10,Salman Butt (PAK),2007-2010,24,24,3,3,0,0,3,1 (1ct 0st),0.125,
11,P Sarraf (NEPAL),2019-2019,9,9,3,3,0,0,3,1 (1ct 0st),0.33299999999999996,
12,BM Scholtz (NAM),2019-2019,14,14,3,3,0,0,3,1 (1ct 0st),0.214,
13,SMSM Senanayake (SL),2012-2016,24,24,3,3,0,0,3,1 (1ct 0st),0.125,
14,Shahzaib Hasan (PAK),2009-2010,10,10,3,3,0,0,3,2 (2ct 0st),0.3,
15,D Sheeli (KUW),2019-2019,3,3,3,3,0,0,3,3 (3ct 0st),1.0,
16,NK Shetty (Mex),2019-2019,2,2,3,3,0,0,3,2 (2ct 0st),1.5,
17,Shiraz Khan (KUW),2019-2019,6,6,3,3,0,0,3,1 (1ct 0st),0.5,
18,P Silas (Botsw),2019-2019,4,4,3,3,0,0,3,1 (1ct 0st),0.75,
19,VS Solanki (ENG),2005-2007,3,3,3,3,0,2,1,2 (2ct 0st),1.0,
20,MWR Stokes (GUE),2019-2019,9,9,3,3,0,0,3,1 (1ct 0st),0.33299999999999996,
21,AO Suji (KENYA),2007-2010,8,8,3,3,0,0,3,1 (1ct 0st),0.375,
22,CR Suryawanshi (SGP),2019-2019,3,3,3,3,0,0,3,1 (1ct 0st),1.0,
23,A Symonds (AUS),2005-2009,14,14,3,3,0,0,3,1 (1ct 0st),0.214,
24,SW Tait (AUS),2007-2016,21,21,3,3,0,0,3,1 (1ct 0st),0.142,
25,SN Thakur (INDIA),2018-2018,7,7,3,3,0,0,3,1 (1ct 0st),0.428,
26,OFJ Tonuu (Samoa),2019-2019,4,4,3,3,0,3,0,1 (1ct 0st),0.75,
27,JD Unadkat (INDIA),2016-2018,10,10,3,3,0,0,3,1 (1ct 0st),0.3,
28,LV van Beek (NL),2014-2016,8,8,3,3,0,0,3,1 (1ct 0st),0.375,
29,HE van der Dussen (SA),2018-2019,9,9,3,3,0,0,3,2 (2ct 0st),0.33299999999999996,
30,M Vijay (INDIA),2010-2015,9,9,3,3,0,0,3,1 (1ct 0st),0.33299999999999996,
31,TP Visee (NL),2015-2019,27,26,3,3,0,0,3,1 (1ct 0st),0.115,
32,AC Voges (AUS),2007-2013,7,7,3,3,0,0,3,1 (1ct 0st),0.428,
33,C Waiswa (UGA),2019-2019,4,4,3,3,0,0,3,1 (1ct 0st),0.75,
34,HR Walsh (USA/WI),2019-2019,13,13,3,3,0,0,3,1 (1ct 0st),0.23,
35,BJ Watling (NZ),2009-2014,5,5,3,3,0,2,1,1 (1ct 0st),0.6,
36,UT Yadav (INDIA),2012-2019,7,7,3,3,0,0,3,1 (1ct 0st),0.428,
37,KJ Young (Blz),2019-2019,3,3,3,3,0,3,0,1 (1ct 0st),1.0,
38,SA Abbott (AUS),2014-2019,4,4,2,2,0,0,2,2 (2ct 0st),0.5,
39,Abdullah Akbarjan (Aut),2019-2019,5,5,2,2,0,0,2,1 (1ct 0st),0.4,
40,Abdul Razzaq (PAK),2006-2013,32,32,2,2,0,0,2,1 (1ct 0st),0.062,
41,Abdul Shakoor (ROM),2019-2019,2,2,2,1,1,1,0,2 (1ct 1st),1.0,
42,AS Abioye (NGA),2019-2019,5,5,2,2,0,0,2,1 (1ct 0st),0.4,
43,IKO Aboagye (Ghana),2019-2019,4,4,2,2,0,0,2,1 (1ct 0st),0.5,
44,Abu Hider (BDESH),2016-2018,13,12,2,2,0,0,2,1 (1ct 0st),0.166,
45,Abdul Hashmi (DEN),2019-2019,8,6,2,1,1,1,0,1 (1ct 0st),0.33299999999999996,
46,Ahmed Faiz (MAL),2019-2019,10,9,2,2,0,0,2,1 (1ct 0st),0.222,
47,CM Akachukwu (NGA),2019-2019,8,8,2,2,0,0,2,2 (2ct 0st),0.25,
48,DI Allan (KENYA),2012-2013,10,10,2,2,0,0,2,1 (1ct 0st),0.2,
49,Alok Kapali (BDESH),2007-2011,7,7,2,2,0,0,2,1 (1ct 0st),0.285,
0,TR Ambrose (ENG),2008-2008,1,1,2,1,1,1,0,2 (1ct 1st),2.0,
1,Amjad Khan (UAE),2015-2016,4,4,2,2,0,0,2,1 (1ct 0st),0.5,
2,Amjad Mahboob (SGP),2019-2019,11,11,2,2,0,0,2,1 (1ct 0st),0.18100000000000002,
3,Amjad Sher (Fin),2019-2019,5,5,2,2,0,0,2,1 (1ct 0st),0.4,
4,Anamul Haque (BDESH),2012-2015,13,12,2,2,0,1,1,1 (1ct 0st),0.166,
5,Anique Uddin (DEN),2019-2019,6,5,2,2,0,0,2,1 (1ct 0st),0.4,
6,R Ankad (Mex),2019-2019,8,8,2,2,0,0,2,1 (1ct 0st),0.25,
7,Anwar Arudin (MAL),2019-2019,12,11,2,2,0,0,2,1 (1ct 0st),0.18100000000000002,
8,Anwar Rahman (MAL),2019-2019,9,8,2,2,0,0,2,1 (1ct 0st),0.25,
9,Areeb Quadir (Fin),2019-2019,2,2,2,2,0,0,2,2 (2ct 0st),1.0,
10,Ashfaq Ahmed (UAE),2018-2019,12,12,2,2,0,0,2,1 (1ct 0st),0.166,
11,MNM Aslam (KUW),2019-2019,6,6,2,2,0,0,2,1 (1ct 0st),0.33299999999999996,
12,Asrar Ahmed (),2019-2019,3,3,2,2,0,0,2,1 (1ct 0st),0.6659999999999999,
13,AA Banner (Blz),2019-2019,3,3,2,2,0,0,2,2 (2ct 0st),0.6659999999999999,
14,GG Banner (Blz),2019-2019,3,3,2,2,0,0,2,2 (2ct 0st),0.6659999999999999,
15,LJ Barker (GUE),2019-2019,9,9,2,2,0,0,2,1 (1ct 0st),0.222,
16,GEF Barnett (CAN),2008-2010,5,5,2,2,0,0,2,1 (1ct 0st),0.4,
17,CD Barnwell (WI),2011-2013,6,6,2,2,0,0,2,1 (1ct 0st),0.33299999999999996,
18,A Bhagwat (HKG),2019-2019,4,4,2,2,0,2,0,2 (2ct 0st),0.5,
19,M Bhanuka (SL),2019-2019,2,2,2,2,0,2,0,1 (1ct 0st),1.0,
20,RA Bhatti (CAN),2012-2012,4,4,2,1,1,1,0,1 (1ct 0st),0.5,
21,DE Bollinger (AUS),2011-2014,9,9,2,2,0,0,2,1 (1ct 0st),0.222,
22,JP Bray (IRE),2009-2009,2,2,2,2,0,0,2,1 (1ct 0st),1.0,
23,GB Brent (ZIM),2006-2007,3,3,2,2,0,0,2,2 (2ct 0st),0.6659999999999999,
24,PR Brown (ENG),2019-2019,4,4,2,2,0,0,2,1 (1ct 0st),0.5,
25,AF Buurman (NL),2010-2010,4,4,2,1,1,1,0,2 (1ct 1st),0.5,
26,VD Chandra (PNM),2019-2019,3,3,2,2,0,2,0,1 (1ct 0st),0.6659999999999999,
27,BB Chari (ZIM),2019-2019,3,3,2,2,0,0,2,1 (1ct 0st),0.6659999999999999,
28,PP Chawla (INDIA),2010-2012,7,7,2,2,0,0,2,2 (2ct 0st),0.285,
29,CK Coventry (ZIM),2010-2015,13,13,2,2,0,1,1,1 (1ct 0st),0.153,
30,KM Dabengwa (ZIM),2006-2010,8,8,2,2,0,0,2,1 (1ct 0st),0.25,
31,F Damiao Couana (Moz),2019-2019,7,6,2,2,0,0,2,1 (1ct 0st),0.33299999999999996,
32,P Danci (ROM),2019-2019,2,2,2,2,0,0,2,2 (2ct 0st),1.0,
33,RR David (CAN),2008-2008,4,4,2,2,0,0,2,1 (1ct 0st),0.5,
34,JM Davison (CAN),2008-2010,5,5,2,2,0,0,2,1 (1ct 0st),0.4,
35,LA Dawson (ENG),2016-2018,6,6,2,2,0,0,2,1 (1ct 0st),0.33299999999999996,
36,TB de Bruyn (SA),2017-2017,2,2,2,2,0,0,2,2 (2ct 0st),1.0,
37,N Deonarine (WI),2010-2013,8,8,2,2,0,0,2,2 (2ct 0st),0.25,
38,AP Devcich (NZ),2013-2014,4,4,2,2,0,0,2,2 (2ct 0st),0.5,
39,R Dhawan (INDIA),2016-2016,1,1,2,2,0,0,2,2 (2ct 0st),2.0,
40,GD Drummond (SCOT),2008-2013,17,17,2,2,0,0,2,1 (1ct 0st),0.11699999999999999,
41,L Emilio (Moz),2019-2019,5,4,2,2,0,0,2,1 (1ct 0st),0.5,
42,GDR Eranga (CAN),2019-2019,9,9,2,2,0,0,2,1 (1ct 0st),0.222,
43,Faran Afzal (ESP),2019-2019,9,9,2,2,0,0,2,1 (1ct 0st),0.222,
44,Fayyaz Butt (OMAN),2019-2019,14,14,2,2,0,0,2,1 (1ct 0st),0.142,
45,A Ferguson (Arg),2019-2019,5,5,2,2,0,0,2,1 (1ct 0st),0.4,
46,N Pradeep (SL),2016-2019,14,14,2,2,0,0,2,1 (1ct 0st),0.142,
47,WIA Fernando (SL),2019-2019,10,10,2,2,0,0,2,1 (1ct 0st),0.2,
48,NJ Ferraby (JER),2019-2019,14,14,2,2,0,0,2,1 (1ct 0st),0.142,
49,SP Fleming (NZ),2005-2006,5,5,2,2,0,0,2,1 (1ct 0st),0.4,
0,DR Flynn (NZ),2008-2012,5,5,2,2,0,0,2,1 (1ct 0st),0.4,
1,JD Freyone (GIBR),2019-2019,4,4,2,2,0,0,2,2 (2ct 0st),0.5,
2,GC Galanis (),2019-2019,2,2,2,2,0,0,2,1 (1ct 0st),1.0,
3,V Ganesan (GER),2019-2019,4,4,2,2,0,0,2,1 (1ct 0st),0.5,
4,CJ Gannon (USA),2019-2019,4,4,2,2,0,0,2,2 (2ct 0st),0.5,
5,Habib Ahmadzai (Aut),2019-2019,5,5,2,2,0,0,2,1 (1ct 0st),0.4,
6,Hamid Hassan (AFG),2010-2016,22,22,2,2,0,0,2,1 (1ct 0st),0.09,
7,Hammad Azam (PAK),2012-2013,5,5,2,2,0,0,2,1 (1ct 0st),0.4,
8,Jandu Hamoud (KUW),2019-2019,6,6,2,2,0,0,2,1 (1ct 0st),0.33299999999999996,
9,AS Hansra (CAN),2012-2013,8,8,2,2,0,0,2,1 (1ct 0st),0.25,
10,Haseeb Amjad (HKG),2014-2016,18,18,2,2,0,0,2,1 (1ct 0st),0.111,
11,JW Hastings (AUS),2010-2016,9,9,2,2,0,0,2,1 (1ct 0st),0.222,
12,C Hauptfleisch (Caym),2019-2019,5,5,2,1,1,1,0,1 (1ct 0st),0.4,
13,Hazratullah Zazai (AFG),2016-2019,13,13,2,2,0,0,2,1 (1ct 0st),0.153,
14,L Hermida (Mex),2019-2019,5,5,2,2,0,0,2,1 (1ct 0st),0.4,
15,D Heyliger (CAN),2019-2019,11,11,2,2,0,0,2,1 (1ct 0st),0.18100000000000002,
16,RM Hira (NZ),2012-2013,15,15,2,2,0,0,2,1 (1ct 0st),0.133,
17,Hirenkumar Patel (Chile),2019-2019,4,4,2,2,0,0,2,1 (1ct 0st),0.5,
18,S Hirugade (Mex),2019-2019,6,6,2,2,0,0,2,1 (1ct 0st),0.33299999999999996,
19,Imran Anwar (BAH),2019-2019,4,4,2,2,0,0,2,1 (1ct 0st),0.5,
20,Imran Ali (KUW),2019-2019,4,4,2,2,0,0,2,2 (2ct 0st),0.5,
21,CA Ingram (SA),2010-2012,9,9,2,2,0,0,2,1 (1ct 0st),0.222,
22,Irfan Ahmed (HKG),2014-2015,8,8,2,2,0,0,2,1 (1ct 0st),0.25,
23,Ismat Ullah (),2019-2019,4,4,2,2,0,0,2,1 (1ct 0st),0.5,
24,H Ivanov (),2019-2019,3,3,2,2,0,2,0,1 (1ct 0st),0.6659999999999999,
25,Joginder Sharma (INDIA),2007-2007,4,4,2,2,0,0,2,1 (1ct 0st),0.5,
26,GO Jones (ENG),2005-2006,2,2,2,2,0,2,0,1 (1ct 0st),1.0,
27,MBS Jonkman (NL),2010-2010,3,3,2,2,0,0,2,2 (2ct 0st),0.6659999999999999,
28,Junaid Siddiqui (CAN),2012-2019,13,13,2,2,0,0,2,1 (1ct 0st),0.153,
29,Junaid Siddique (UAE),2019-2019,8,8,2,2,0,0,2,1 (1ct 0st),0.25,
30,Karweng NG (PHI),2019-2019,4,4,2,2,0,0,2,2 (2ct 0st),0.5,
31,MS Kasprowicz (AUS),2005-2005,2,2,2,2,0,0,2,1 (1ct 0st),1.0,
32,SM Katich (AUS),2005-2006,3,3,2,2,0,0,2,1 (1ct 0st),0.6659999999999999,
33,Z Khan (INDIA),2006-2012,17,17,2,2,0,0,2,1 (1ct 0st),0.11699999999999999,
34,Khurram Khan (UAE),2014-2014,3,3,2,2,0,0,2,1 (1ct 0st),0.6659999999999999,
35,M Klinger (AUS),2017-2017,3,3,2,2,0,0,2,1 (1ct 0st),0.6659999999999999,
36,HGJM Kulatunga (SL),2008-2008,2,2,2,2,0,0,2,2 (2ct 0st),1.0,
37,JS Kundi (KENYA),2019-2019,6,6,2,2,0,0,2,1 (1ct 0st),0.33299999999999996,
38,A Lark (Aut),2019-2019,5,5,2,2,0,0,2,1 (1ct 0st),0.4,
39,LC Le Tissier (GUE),2019-2019,9,9,2,2,0,0,2,2 (2ct 0st),0.222,
40,JB Little (IRE),2016-2019,11,11,2,2,0,0,2,1 (1ct 0st),0.18100000000000002,
41,MF Maharoof (SL),2006-2016,8,8,2,2,0,0,2,1 (1ct 0st),0.25,
42,NA Maiolo (ITA),2019-2019,8,7,2,2,0,0,2,1 (1ct 0st),0.285,
43,DJ Malan (ENG),2017-2019,9,9,2,2,0,0,2,1 (1ct 0st),0.222,
44,JN Malan (SA),2019-2019,2,2,2,2,0,0,2,1 (1ct 0st),1.0,
45,A Manousis (),2019-2019,3,3,2,2,0,0,2,1 (1ct 0st),0.6659999999999999,
46,Mansoor Amjad (PAK),2008-2008,1,1,2,2,0,0,2,2 (2ct 0st),2.0,
47,A Martin (WI),2011-2011,1,1,2,2,0,0,2,2 (2ct 0st),2.0,
48,SW Masakadza (ZIM),2010-2013,7,7,2,2,0,0,2,1 (1ct 0st),0.285,
49,WT Mashinge (ZIM),2019-2019,2,2,2,2,0,0,2,2 (2ct 0st),1.0,
0,NO Miller (WI),2009-2014,9,9,2,2,0,0,2,1 (1ct 0st),0.222,
1,SF Mire (ZIM),2018-2019,9,9,2,2,0,0,2,1 (1ct 0st),0.222,
2,Mohammad Ghazanfar (HKG),2019-2019,5,5,2,2,0,0,2,1 (1ct 0st),0.4,
3,Mohammad Naim (BDESH),2019-2019,3,3,2,2,0,0,2,2 (2ct 0st),0.6659999999999999,
4,Mohammad Salman (PAK),2011-2011,1,1,2,1,1,1,0,2 (1ct 1st),2.0,
5,Mohammed Asghar (KUW),2019-2019,4,4,2,2,0,0,2,1 (1ct 0st),0.5,
6,Mohammed Nurji (MWI),2019-2019,6,6,2,2,0,0,2,1 (1ct 0st),0.33299999999999996,
7,RS Morton (WI),2006-2010,7,7,2,2,0,0,2,1 (1ct 0st),0.285,
8,Muhammad Kashif (KUW),2019-2019,10,10,2,2,0,0,2,1 (1ct 0st),0.2,
9,Muhammad Nadeem (Saudi),2019-2019,5,5,2,2,0,0,2,2 (2ct 0st),0.4,
10,RG Mukasa (UGA),2019-2019,4,4,2,2,0,0,2,1 (1ct 0st),0.5,
11,Mukhtar Ahmed (PAK),2015-2015,6,6,2,2,0,0,2,1 (1ct 0st),0.33299999999999996,
12,J Mulder (IRE),2016-2017,8,8,2,2,0,0,2,1 (1ct 0st),0.25,
13,G Murali (CRC),2019-2019,3,3,2,2,0,2,0,1 (1ct 0st),0.6659999999999999,
14,Murid Ekrami (Belg),2019-2019,3,3,2,2,0,0,2,2 (2ct 0st),0.6659999999999999,
15,TK Musakanda (ZIM),2018-2018,6,6,2,2,0,0,2,1 (1ct 0st),0.33299999999999996,
16,LA Musiani (Arg),2019-2019,5,5,2,2,0,0,2,1 (1ct 0st),0.4,
17,CT Mutombodzi (ZIM),2013-2019,13,13,2,2,0,0,2,1 (1ct 0st),0.153,
18,B Muzarabani (ZIM),2018-2018,6,6,2,2,0,0,2,1 (1ct 0st),0.33299999999999996,
19,Naeem Islam (BDESH),2008-2013,10,10,2,2,0,0,2,1 (1ct 0st),0.2,
20,Nanda Kumar (CRC),2019-2019,3,3,2,2,0,0,2,2 (2ct 0st),0.6659999999999999,
21,N Nankov (),2019-2019,3,3,2,2,0,0,2,1 (1ct 0st),0.6659999999999999,
22,Naved-ul-Hasan (PAK),2006-2010,4,4,2,2,0,0,2,1 (1ct 0st),0.5,
23,Nawazish Jezuli (Saudi),2019-2019,1,1,2,2,0,2,0,2 (2ct 0st),2.0,
24,Najmul Hossain Shanto (BDESH),2019-2019,2,2,2,2,0,0,2,1 (1ct 0st),1.0,
25,Nazmul Islam (BDESH),2018-2018,13,13,2,2,0,0,2,1 (1ct 0st),0.153,
26,Nazwan Ismail (Mald),2019-2019,3,3,2,2,0,0,2,1 (1ct 0st),0.6659999999999999,
27,P Negi (INDIA),2016-2016,1,1,2,2,0,0,2,2 (2ct 0st),2.0,
28,K Nestor (GIBR),2019-2019,4,4,2,2,0,0,2,1 (1ct 0st),0.5,
29,G Nikitas (),2019-2019,2,2,2,0,2,0,0,2 (0ct 2st),1.0,
30,Noor Momand (Belg),2019-2019,2,2,2,2,0,2,0,1 (1ct 0st),1.0,
31,F Nsubuga (UGA),2019-2019,3,3,2,2,0,0,2,1 (1ct 0st),0.6659999999999999,
32,M Ntini (SA),2005-2011,10,10,2,2,0,0,2,1 (1ct 0st),0.2,
33,GH O'Brien (BMUDA),2008-2019,11,11,2,2,0,0,2,1 (1ct 0st),0.18100000000000002,
34,SA Okpe (NGA),2019-2019,8,8,2,2,0,0,2,1 (1ct 0st),0.25,
35,LN Oluoch (KENYA),2013-2019,10,10,2,2,0,0,2,1 (1ct 0st),0.2,
36,AA Onikoyi (NGA),2019-2019,9,9,2,2,0,2,0,1 (1ct 0st),0.222,
37,E Otieno (KENYA),2012-2019,18,18,2,2,0,0,2,1 (1ct 0st),0.111,
38,KO Otieno (KENYA),2008-2008,4,4,2,2,0,0,2,1 (1ct 0st),0.5,
39,HC Overdijk (NL),2018-2019,4,3,2,2,0,0,2,2 (2ct 0st),0.6659999999999999,
40,AM Oyede (NGA),2019-2019,8,8,2,2,0,0,2,2 (2ct 0st),0.25,
41,T Panyangara (ZIM),2013-2016,14,14,2,2,0,0,2,1 (1ct 0st),0.142,
42,AE Paraam (SGP),2019-2019,3,3,2,2,0,0,2,1 (1ct 0st),0.6659999999999999,
43,SD Parry (ENG),2014-2015,5,5,2,2,0,0,2,2 (2ct 0st),0.4,
44,IK Pathan (INDIA),2006-2012,24,23,2,2,0,0,2,1 (1ct 0st),0.086,
45,KMA Paul (WI),2018-2019,18,18,2,2,0,0,2,1 (1ct 0st),0.111,
46,T Perera (Botsw),2019-2019,6,6,2,2,0,0,2,1 (1ct 0st),0.33299999999999996,
47,JE Pitcher (BMUDA),2019-2019,3,3,2,2,0,0,2,2 (2ct 0st),0.6659999999999999,
48,OL Pitcher (BMUDA),2008-2008,3,3,2,2,0,0,2,2 (2ct 0st),0.6659999999999999,
49,SM Pollock (SA),2005-2008,12,12,2,2,0,0,2,1 (1ct 0st),0.166,
0,NS Poonia (SCOT),2007-2010,8,7,2,2,0,0,2,1 (1ct 0st),0.285,
1,A Poulose (OMAN),2017-2017,3,3,2,2,0,0,2,1 (1ct 0st),0.6659999999999999,
2,DBL Powell (WI),2007-2007,5,5,2,2,0,0,2,1 (1ct 0st),0.4,
3,AD Poynter (IRE),2012-2016,19,17,2,2,0,0,2,1 (1ct 0st),0.11699999999999999,
4,A Pusthay (Fin),2019-2019,5,5,2,2,0,0,2,1 (1ct 0st),0.4,
5,Qadeer Ahmed (UAE),2015-2019,10,10,2,2,0,0,2,1 (1ct 0st),0.2,
6,Raees Ahmadzai (AFG),2010-2010,8,8,2,2,0,0,2,1 (1ct 0st),0.25,
7,Raag Kapur (HKG),2019-2019,4,4,2,2,0,0,2,1 (1ct 0st),0.5,
8,S Rakshit (CZK-R),2019-2019,7,7,2,2,0,0,2,1 (1ct 0st),0.285,
9,R Rampaul (WI),2007-2015,23,23,2,2,0,0,2,1 (1ct 0st),0.086,
10,Raza-ur-Rehman (CAN),2012-2013,5,5,2,2,0,0,2,1 (1ct 0st),0.4,
11,Raza Hasan (PAK),2012-2014,10,10,2,2,0,0,2,1 (1ct 0st),0.2,
12,DJ Reekers (NL),2008-2009,6,5,2,2,0,0,2,1 (1ct 0st),0.4,
13,GA Reynold (Blz),2019-2019,3,3,2,2,0,0,2,2 (2ct 0st),0.6659999999999999,
14,LH Rodrigues (),2019-2019,4,4,2,2,0,0,2,1 (1ct 0st),0.5,
15,R Rohan (SGP),2019-2019,10,10,2,2,0,0,2,1 (1ct 0st),0.2,
16,S Rossi (Arg),2019-2019,5,5,2,2,0,0,2,1 (1ct 0st),0.4,
17,Saber Zakhil (Belg),2019-2019,3,3,2,2,0,0,2,1 (1ct 0st),0.6659999999999999,
18,S Saeed (Mald),2019-2019,5,5,2,2,0,0,2,2 (2ct 0st),0.4,
19,Sagar Pun (NEPAL),2014-2015,9,9,2,2,0,0,2,1 (1ct 0st),0.222,
20,Sahibzada Farhan (PAK),2018-2018,3,3,2,2,0,0,2,2 (2ct 0st),0.6659999999999999,
21,J Salazar (Peru),2019-2019,2,2,2,2,0,0,2,1 (1ct 0st),1.0,
22,Saqib Zulfiqar (NL),2018-2019,6,6,2,2,0,0,2,2 (2ct 0st),0.33299999999999996,
23,A Sathya (Mex),2019-2019,3,3,2,2,0,0,2,1 (1ct 0st),0.6659999999999999,
24,V Sehwag (INDIA),2006-2012,19,18,2,2,0,0,2,1 (1ct 0st),0.111,
25,Shaikh Ashraf (Peru),2019-2019,4,4,2,2,0,0,2,2 (2ct 0st),0.5,
26,Shakeel Ansar (PAK),2012-2012,2,2,2,1,1,1,0,2 (1ct 1st),1.0,
27,PH Shamdasani (Peru),2019-2019,4,4,2,2,0,0,2,1 (1ct 0st),0.5,
28,Shamsur Rahman (BDESH),2013-2014,9,8,2,2,0,0,2,1 (1ct 0st),0.25,
29,V Shankar (INDIA),2018-2019,9,9,2,2,0,0,2,1 (1ct 0st),0.222,
30,Shoaib Akhtar (PAK),2006-2010,15,15,2,2,0,0,2,1 (1ct 0st),0.133,
31,Shoaib Ali (Saudi),2019-2019,5,5,2,2,0,0,2,2 (2ct 0st),0.4,
32,Shoaib Qureshi (Fin),2019-2019,5,5,2,2,0,0,2,1 (1ct 0st),0.4,
33,Sidhant Singh (SGP),2019-2019,8,8,2,2,0,0,2,1 (1ct 0st),0.25,
34,RP Singh (INDIA),2007-2009,10,9,2,2,0,0,2,1 (1ct 0st),0.222,
35,L Sipamla (SA),2019-2019,5,5,2,2,0,0,2,1 (1ct 0st),0.4,
36,S Smith (BMUDA),2019-2019,5,5,2,2,0,2,0,1 (1ct 0st),0.4,
37,S Snater (NL),2018-2019,13,12,2,2,0,0,2,1 (1ct 0st),0.166,
38,Sohag Gazi (BDESH),2012-2015,10,10,2,2,0,0,2,1 (1ct 0st),0.2,
39,CA Soper (PNG),2015-2019,13,13,2,2,0,0,2,1 (1ct 0st),0.153,
40,S Sreesanth (INDIA),2006-2008,10,9,2,2,0,0,2,2 (2ct 0st),0.222,
41,H Srinivasan (GER),2019-2019,1,1,2,1,1,1,0,2 (1ct 1st),2.0,
42,JH Stander (SCOT),2009-2012,11,11,2,2,0,0,2,1 (1ct 0st),0.18100000000000002,
43,F Stoman (PORT),2019-2019,4,4,2,1,1,1,0,2 (1ct 1st),0.5,
44,DC Stovell (BMUDA),2019-2019,6,6,2,2,0,0,2,1 (1ct 0st),0.33299999999999996,
45,GM Strydom (Caym),2019-2019,6,6,2,2,0,0,2,1 (1ct 0st),0.33299999999999996,
46,JTS Sumerauer (JER),2019-2019,8,8,2,2,0,0,2,1 (1ct 0st),0.25,
47,K Suttisan (THAI),2019-2019,2,2,2,2,0,0,2,2 (2ct 0st),1.0,
48,Syed Aziz (MAL),2019-2019,14,13,2,2,0,0,2,1 (1ct 0st),0.153,
49,Tahir Dar (BAH),2019-2019,4,4,2,2,0,0,2,1 (1ct 0st),0.5,
0,Tauqeer Hussain (ESP),2019-2019,4,4,2,2,0,0,2,1 (1ct 0st),0.5,
1,WU Tharanga (SL),2006-2018,26,26,2,2,0,0,2,1 (1ct 0st),0.076,
2,J Theron (SA),2010-2012,9,9,2,2,0,0,2,1 (1ct 0st),0.222,
3,RA Thomas (CAN),2019-2019,8,8,2,2,0,0,2,1 (1ct 0st),0.25,
4,GJ Thompson (IRE),2016-2019,10,10,2,2,0,0,2,1 (1ct 0st),0.2,
5,T Thushara (SL),2008-2010,6,6,2,2,0,0,2,1 (1ct 0st),0.33299999999999996,
6,DT Tiripano (ZIM),2016-2019,10,10,2,2,0,0,2,1 (1ct 0st),0.2,
7,MK Tiwary (INDIA),2011-2012,3,3,2,2,0,0,2,2 (2ct 0st),0.6659999999999999,
8,JC Tredwell (ENG),2012-2014,17,16,2,2,0,0,2,1 (1ct 0st),0.125,
9,ME Trescothick (ENG),2005-2006,3,3,2,2,0,0,2,2 (2ct 0st),0.6659999999999999,
10,T Tshose (Botsw),2019-2019,2,2,2,2,0,0,2,1 (1ct 0st),1.0,
11,E Ul Haq (NOR),2019-2019,5,5,2,2,0,0,2,1 (1ct 0st),0.4,
12,Umar Adam (Mald),2019-2019,11,11,2,2,0,0,2,1 (1ct 0st),0.18100000000000002,
13,RV Uthappa (INDIA),2007-2015,13,12,2,2,0,1,1,1 (1ct 0st),0.166,
14,R van der Merwe (Arg),2019-2019,5,5,2,2,0,0,2,1 (1ct 0st),0.4,
15,S Vashisht (ROM),2019-2019,3,3,2,2,0,0,2,1 (1ct 0st),0.6659999999999999,
16,Vichanath Singh (THAI),2019-2019,4,4,2,2,0,0,2,1 (1ct 0st),0.5,
17,Vinod Kumar (ESP),2019-2019,3,3,2,2,0,0,2,2 (2ct 0st),0.6659999999999999,
18,BV Vitori (ZIM),2012-2016,11,11,2,2,0,0,2,1 (1ct 0st),0.18100000000000002,
19,Waheed Ahmed (UAE),2019-2019,10,10,2,2,0,0,2,1 (1ct 0st),0.2,
20,SR Welsh (CAN),2008-2008,1,1,2,2,0,0,2,2 (2ct 0st),2.0,
21,AR White (IRE),2008-2012,18,17,2,2,0,0,2,1 (1ct 0st),0.11699999999999999,
22,CG Williams (NAM),2019-2019,13,13,2,2,0,0,2,1 (1ct 0st),0.153,
23,OR Willis (Caym),2019-2019,3,3,2,1,1,0,1,1 (1ct 0st),0.6659999999999999,
24,C Wright (Caym),2019-2019,6,6,2,2,0,0,2,1 (1ct 0st),0.33299999999999996,
25,Yasar Haroon (),2019-2019,4,4,2,2,0,0,2,1 (1ct 0st),0.5,
26,Yusuf Ebrahim (PNM),2019-2019,3,3,2,2,0,0,2,2 (2ct 0st),0.6659999999999999,
27,Zahoor Khan (UAE),2017-2019,18,18,2,2,0,0,2,1 (1ct 0st),0.111,
28,C Zhuwao (ZIM),2008-2018,7,7,2,2,0,0,2,1 (1ct 0st),0.285,
29,Zishan Shah (DEN),2019-2019,6,4,2,2,0,0,2,1 (1ct 0st),0.5,
30,B Zuiderent (NL),2009-2010,6,6,2,2,0,0,2,1 (1ct 0st),0.33299999999999996,
31,M Abdulla (MWI),2019-2019,5,5,1,1,0,0,1,1 (1ct 0st),0.2,
32,Abdul Shakoor (UAE),2015-2019,6,6,1,0,1,0,0,1 (0ct 1st),0.166,
33,Abdul Wahid (Saudi),2019-2019,5,5,1,1,0,0,1,1 (1ct 0st),0.2,
34,Abraash Khan (CAN),2019-2019,7,7,1,1,0,0,1,1 (1ct 0st),0.142,
35,Abrar Bilal (Aut),2019-2019,3,3,1,0,1,0,0,1 (0ct 1st),0.33299999999999996,
36,Abu Jayed (BDESH),2018-2018,3,3,1,1,0,0,1,1 (1ct 0st),0.33299999999999996,
37,AR Adams (NZ),2005-2006,4,4,1,1,0,0,1,1 (1ct 0st),0.25,
38,VD Adewoye (NGA),2019-2019,7,7,1,1,0,0,1,1 (1ct 0st),0.142,
39,Afsar Zazai (AFG),2013-2013,1,1,1,0,1,0,0,1 (0ct 1st),1.0,
40,GJ Agius (MALTA),2019-2019,2,2,1,1,0,0,1,1 (1ct 0st),0.5,
41,P Agnihotri (NOR),2019-2019,2,2,1,1,0,0,1,1 (1ct 0st),0.5,
42,SA Ahmad (DEN),2019-2019,5,3,1,1,0,0,1,1 (1ct 0st),0.33299999999999996,
43,Ahmed Hassan (Mald),2019-2019,11,11,1,1,0,0,1,1 (1ct 0st),0.09,
44,GW Aldridge (NZ),2011-2011,1,1,1,1,0,0,1,1 (1ct 0st),1.0,
45,Amir Ali (OMAN),2015-2016,10,9,1,1,0,0,1,1 (1ct 0st),0.111,
46,Amjad Ali (UAE),2014-2015,5,5,1,1,0,0,1,1 (1ct 0st),0.2,
47,Anam Mollik (ITA),2019-2019,2,2,1,1,0,0,1,1 (1ct 0st),0.5,
48,Anasim Khan (BAH),2019-2019,4,4,1,1,0,0,1,1 (1ct 0st),0.25,
49,Aqib Iqbal (Aut),2019-2019,5,5,1,1,0,0,1,1 (1ct 0st),0.2,
0,S Arachchige (ITA),2019-2019,4,4,1,1,0,0,1,1 (1ct 0st),0.25,
1,Arafat Sunny (BDESH),2014-2016,10,10,1,1,0,0,1,1 (1ct 0st),0.1,
2,Aritra Dutta (SGP),2019-2019,8,8,1,1,0,0,1,1 (1ct 0st),0.125,
3,P Arora (Mex),2019-2019,2,2,1,1,0,0,1,1 (1ct 0st),0.5,
4,U Aryaman Sunil (SGP),2019-2019,2,2,1,1,0,0,1,1 (1ct 0st),0.5,
5,Ashiqullah Said (Belg),2019-2019,3,3,1,1,0,0,1,1 (1ct 0st),0.33299999999999996,
6,A Ashokan (CZK-R),2019-2019,2,2,1,1,0,0,1,1 (1ct 0st),0.5,
7,Aslam Mohammad (),2019-2019,3,3,1,1,0,0,1,1 (1ct 0st),0.33299999999999996,
8,SK Atai (PNG),2019-2019,2,2,1,1,0,0,1,1 (1ct 0st),0.5,
9,V Ateak (Ghana),2019-2019,4,4,1,1,0,0,1,1 (1ct 0st),0.25,
10,Atif Kamal (LUX),2019-2019,4,4,1,1,0,0,1,1 (1ct 0st),0.25,
11,MS Aulakh (CAN),2012-2013,3,3,1,1,0,0,1,1 (1ct 0st),0.33299999999999996,
12,Avi Dixit (SGP),2019-2019,1,1,1,1,0,0,1,1 (1ct 0st),1.0,
13,Awais Malik (QAT),2019-2019,11,11,1,1,0,0,1,1 (1ct 0st),0.09,
14,MO Bacarese (GIBR),2019-2019,3,3,1,1,0,0,1,1 (1ct 0st),0.33299999999999996,
15,KS Bagabena (Ghana),2019-2019,4,4,1,1,0,0,1,1 (1ct 0st),0.25,
16,JD Baker (Samoa),2019-2019,4,4,1,1,0,0,1,1 (1ct 0st),0.25,
17,G Bakiweyem (Ghana),2019-2019,3,3,1,1,0,0,1,1 (1ct 0st),0.33299999999999996,
18,WD Balaji Rao (CAN),2008-2008,4,4,1,1,0,0,1,1 (1ct 0st),0.25,
19,Baljit Singh (ITA),2019-2019,8,7,1,1,0,0,1,1 (1ct 0st),0.142,
20,JT Ball (ENG),2018-2018,2,2,1,1,0,0,1,1 (1ct 0st),0.5,
21,CT Bancroft (AUS),2016-2016,1,1,1,1,0,1,0,1 (1ct 0st),1.0,
22,HMCM Bandara (SL),2006-2009,4,4,1,1,0,0,1,1 (1ct 0st),0.25,
23,S Bantzas (),2019-2019,1,1,1,1,0,0,1,1 (1ct 0st),1.0,
24,AB Barath (WI),2010-2011,2,2,1,1,0,0,1,1 (1ct 0st),0.5,
25,J Barker (LUX),2019-2019,4,4,1,1,0,0,1,1 (1ct 0st),0.25,
26,P Baron (Arg),2019-2019,5,5,1,1,0,0,1,1 (1ct 0st),0.2,
27,OO Bascome (BMUDA),2008-2019,3,3,1,1,0,0,1,1 (1ct 0st),0.33299999999999996,
28,T Bavuma (SA),2019-2019,2,2,1,1,0,0,1,1 (1ct 0st),0.5,
29,RL Bhudia (KENYA),2007-2007,3,3,1,1,0,0,1,1 (1ct 0st),0.33299999999999996,
30,SR Bhudia (KENYA),2019-2019,4,4,1,1,0,0,1,1 (1ct 0st),0.25,
31,Bilawal Bhatti (PAK),2013-2015,9,9,1,1,0,0,1,1 (1ct 0st),0.111,
32,TR Birt (AUS),2010-2012,4,4,1,1,0,0,1,1 (1ct 0st),0.25,
33,D Bishoo (WI),2011-2019,7,7,1,1,0,0,1,1 (1ct 0st),0.142,
34,JAR Blain (SCOT),2007-2008,6,5,1,1,0,0,1,1 (1ct 0st),0.2,
35,TA Blundell (NZ),2017-2018,3,3,1,1,0,1,0,1 (1ct 0st),0.33299999999999996,
36,SM Boland (AUS),2016-2016,3,3,1,1,0,0,1,1 (1ct 0st),0.33299999999999996,
37,SG Borthwick (ENG),2011-2011,1,1,1,1,0,0,1,1 (1ct 0st),1.0,
38,LE Bosman (SA),2006-2010,14,14,1,1,0,0,1,1 (1ct 0st),0.071,
39,IDR Bradshaw (WI),2006-2006,1,1,1,1,0,0,1,1 (1ct 0st),1.0,
40,DR Briggs (ENG),2012-2014,7,6,1,1,0,0,1,1 (1ct 0st),0.166,
41,N Buckle (GUE),2019-2019,3,3,1,1,0,0,1,1 (1ct 0st),0.33299999999999996,
42,J Bulele (Moz),2019-2019,7,6,1,1,0,0,1,1 (1ct 0st),0.166,
43,DE Burgess (Samoa),2019-2019,4,4,1,1,0,0,1,1 (1ct 0st),0.25,
44,DK Butler (WI),2006-2006,1,1,1,1,0,0,1,1 (1ct 0st),1.0,
45,CL Cairns (NZ),2005-2006,2,2,1,1,0,0,1,1 (1ct 0st),0.5,
46,JD Campbell (WI),2019-2019,2,2,1,1,0,0,1,1 (1ct 0st),0.5,
47,RJ Campbell (HKG),2016-2016,3,3,1,1,0,0,1,1 (1ct 0st),0.33299999999999996,
48,MA Carberry (ENG),2014-2014,1,1,1,1,0,0,1,1 (1ct 0st),1.0,
49,NM Carter (SCOT),2013-2013,7,7,1,1,0,0,1,1 (1ct 0st),0.142,
0,P Chandran (Mex),2019-2019,3,3,1,1,0,0,1,1 (1ct 0st),0.33299999999999996,
1,N Chejay (BHU),2019-2019,1,1,1,1,0,0,1,1 (1ct 0st),1.0,
2,TS Chisoro (ZIM),2015-2018,12,12,1,1,0,0,1,1 (1ct 0st),0.083,
3,AN Cook (ENG),2007-2009,4,4,1,1,0,0,1,1 (1ct 0st),0.25,
4,J Cutinho (CRC),2019-2019,3,3,1,1,0,0,1,1 (1ct 0st),0.33299999999999996,
5,DK Dahyabhai Ahir (PNM),2019-2019,2,2,1,1,0,0,1,1 (1ct 0st),0.5,
6,JWM Dalrymple (ENG),2006-2007,3,3,1,1,0,0,1,1 (1ct 0st),0.33299999999999996,
7,H Dandapani (Fin),2019-2019,5,5,1,1,0,0,1,1 (1ct 0st),0.2,
8,K Dasan (),2019-2019,3,3,1,1,0,0,1,1 (1ct 0st),0.33299999999999996,
9,AS Dean (CAN),2008-2013,2,2,1,1,0,0,1,1 (1ct 0st),0.5,
10,M de Lange (SA),2012-2015,6,6,1,1,0,0,1,1 (1ct 0st),0.166,
11,CJ Delany (GIBR),2019-2019,4,4,1,1,0,0,1,1 (1ct 0st),0.25,
12,SI de Saram (SL),2009-2009,1,1,1,1,0,0,1,1 (1ct 0st),1.0,
13,PC de Silva (SL),2017-2017,2,2,1,1,0,0,1,1 (1ct 0st),0.5,
14,Dhiman Ghosh (BDESH),2008-2008,1,1,1,0,1,0,0,1 (0ct 1st),1.0,
15,AB Dinda (INDIA),2009-2012,9,9,1,1,0,0,1,1 (1ct 0st),0.111,
16,LA Dunbar (Serb),2019-2019,2,2,1,1,0,1,0,1 (1ct 0st),0.5,
17,AB Dursak (TKY),2019-2019,4,4,1,1,0,0,1,1 (1ct 0st),0.25,
18,G Dutta (Mex),2019-2019,7,7,1,1,0,0,1,1 (1ct 0st),0.142,
19,J Edness (BMUDA),2008-2008,3,3,1,0,1,0,0,1 (0ct 1st),0.33299999999999996,
20,RMS Eranga (SL),2012-2013,3,3,1,1,0,0,1,1 (1ct 0st),0.33299999999999996,
21,L Evile (Samoa),2019-2019,4,4,1,1,0,0,1,1 (1ct 0st),0.25,
22,M Faheem (THAI),2019-2019,4,4,1,1,0,0,1,1 (1ct 0st),0.25,
23,Faisal Khan (Saudi),2019-2019,4,4,1,1,0,0,1,1 (1ct 0st),0.25,
24,Fareed Ahmad (AFG),2016-2019,14,14,1,1,0,0,1,1 (1ct 0st),0.071,
25,Farhan Ahmed (UAE),2016-2016,3,3,1,1,0,0,1,1 (1ct 0st),0.33299999999999996,
26,Fayyaz Ahmed (UAE),2015-2015,1,1,1,1,0,0,1,1 (1ct 0st),1.0,
27,CJ Ferguson (AUS),2009-2009,3,3,1,1,0,0,1,1 (1ct 0st),0.33299999999999996,
28,SE Findlay (WI),2008-2008,2,2,1,1,0,0,1,1 (1ct 0st),0.5,
29,JA Fitzgerald (GIBR),2019-2019,4,4,1,1,0,0,1,1 (1ct 0st),0.25,
30,BT Foakes (ENG),2019-2019,1,1,1,1,0,1,0,1 (1ct 0st),1.0,
31,CR Foggo (BMUDA),2008-2008,3,3,1,1,0,0,1,1 (1ct 0st),0.33299999999999996,
32,TS Fray (BMUDA),2019-2019,10,10,1,1,0,0,1,1 (1ct 0st),0.1,
33,C Fry (LUX),2019-2019,3,3,1,1,0,0,1,1 (1ct 0st),0.33299999999999996,
34,R Frylinck (SA),2017-2018,3,3,1,1,0,0,1,1 (1ct 0st),0.33299999999999996,
35,ST Gabriel (WI),2013-2013,2,2,1,1,0,0,1,1 (1ct 0st),0.5,
36,WT Gavera (PNG),2015-2017,6,6,1,1,0,0,1,1 (1ct 0st),0.166,
37,Gershon Yusuf (NGA),2019-2019,1,1,1,1,0,0,1,1 (1ct 0st),1.0,
38,MR Gillespie (NZ),2006-2008,11,11,1,1,0,0,1,1 (1ct 0st),0.09,
39,R Goodwin (PHI),2019-2019,4,4,1,1,0,0,1,1 (1ct 0st),0.25,
40,JOA Gordon (CAN),2013-2019,7,7,1,1,0,0,1,1 (1ct 0st),0.142,
41,TG Gordon (CAN),2012-2012,3,3,1,1,0,0,1,1 (1ct 0st),0.33299999999999996,
42,K Gore (USA),2019-2019,4,4,1,1,0,0,1,1 (1ct 0st),0.25,
43,H Gori (CZK-R),2019-2019,7,7,1,1,0,0,1,1 (1ct 0st),0.142,
44,S Goud (CZK-R),2019-2019,1,1,1,1,0,0,1,1 (1ct 0st),1.0,
45,AM Guruge (UAE),2014-2015,5,5,1,1,0,0,1,1 (1ct 0st),0.2,
46,Hafez Farooq (Peru),2019-2019,4,4,1,1,0,0,1,1 (1ct 0st),0.25,
47,OJ Hairs (SCOT),2019-2019,8,8,1,1,0,0,1,1 (1ct 0st),0.125,
48,Hamza Dar (ESP),2019-2019,1,1,1,1,0,0,1,1 (1ct 0st),1.0,
49,SJ Harmison (ENG),2005-2006,2,2,1,1,0,0,1,1 (1ct 0st),0.5,
0,NM Hauritz (AUS),2009-2009,3,3,1,1,0,0,1,1 (1ct 0st),0.33299999999999996,
1,ML Hayden (AUS),2005-2007,9,9,1,1,0,0,1,1 (1ct 0st),0.111,
2,JR Hazlewood (AUS),2013-2016,7,7,1,1,0,0,1,1 (1ct 0st),0.142,
3,MJ Henry (NZ),2014-2017,6,6,1,1,0,0,1,1 (1ct 0st),0.166,
4,WW Hinds (WI),2006-2010,5,5,1,1,0,0,1,1 (1ct 0st),0.2,
5,GB Hogg (AUS),2006-2014,15,15,1,1,0,0,1,1 (1ct 0st),0.066,
6,Z Hoque (THAI),2019-2019,3,3,1,1,0,0,1,1 (1ct 0st),0.33299999999999996,
7,JM How (NZ),2007-2008,5,5,1,1,0,0,1,1 (1ct 0st),0.2,
8,MG Hunter (GIBR),2019-2019,4,4,1,1,0,0,1,1 (1ct 0st),0.25,
9,JJ Huo (Moz),2019-2019,7,6,1,1,0,0,1,1 (1ct 0st),0.166,
10,J Hurley (Arg),2019-2019,3,3,1,1,0,0,1,1 (1ct 0st),0.33299999999999996,
11,A Husain (Arg),2019-2019,5,5,1,1,0,0,1,1 (1ct 0st),0.2,
12,GM Hyde (Blz),2019-2019,3,3,1,1,0,0,1,1 (1ct 0st),0.33299999999999996,
13,Ibrahim Nashath (Mald),2019-2019,3,3,1,1,0,0,1,1 (1ct 0st),0.33299999999999996,
14,Ibrahim Rizan (Mald),2019-2019,5,5,1,1,0,0,1,1 (1ct 0st),0.2,
15,Ibrahim Zadran (AFG),2019-2019,3,3,1,1,0,0,1,1 (1ct 0st),0.33299999999999996,
16,AF Ifill (Caym),2019-2019,6,6,1,1,0,0,1,1 (1ct 0st),0.166,
17,Iftikhar Ahmed (PAK),2016-2019,6,6,1,1,0,0,1,1 (1ct 0st),0.166,
18,Ilyas Ahmed (KUW),2019-2019,6,6,1,1,0,0,1,1 (1ct 0st),0.166,
19,Imran Ashraf (QAT),2019-2019,3,3,1,1,0,0,1,1 (1ct 0st),0.33299999999999996,
20,Imran Haider (UAE),2016-2019,11,11,1,1,0,0,1,1 (1ct 0st),0.09,
21,PJ Ingram (NZ),2010-2010,3,3,1,1,0,0,1,1 (1ct 0st),0.33299999999999996,
22,DF Jacobs (THAI),2019-2019,4,4,1,1,0,0,1,1 (1ct 0st),0.25,
23,KM Jadhav (INDIA),2015-2017,9,9,1,1,0,0,1,1 (1ct 0st),0.111,
24,S Jamil (Belg),2019-2019,3,3,1,1,0,0,1,1 (1ct 0st),0.33299999999999996,
25,Jasdeep Singh (USA),2019-2019,4,4,1,1,0,0,1,1 (1ct 0st),0.25,
26,Jaspreet Singh (ITA),2019-2019,5,4,1,1,0,0,1,1 (1ct 0st),0.25,
27,K Jethi (CAN),2008-2008,5,5,1,1,0,0,1,1 (1ct 0st),0.2,
28,J Jojo (DEN),2019-2019,7,5,1,1,0,0,1,1 (1ct 0st),0.2,
29,MO Jones (BMUDA),2019-2019,8,8,1,1,0,0,1,1 (1ct 0st),0.125,
30,NG Jones (IRE),2010-2012,5,4,1,1,0,0,1,1 (1ct 0st),0.25,
31,C Jonker (SA),2018-2018,2,2,1,1,0,0,1,1 (1ct 0st),0.5,
32,Junaid Siddique (BDESH),2007-2012,7,7,1,1,0,0,1,1 (1ct 0st),0.142,
33,Kaleem Shah (Moz),2019-2019,7,6,1,1,0,0,1,1 (1ct 0st),0.166,
34,JK Kamande (KENYA),2007-2010,12,12,1,1,0,0,1,1 (1ct 0st),0.083,
35,Kamran Shazad (UAE),2014-2014,3,3,1,1,0,0,1,1 (1ct 0st),0.33299999999999996,
36,TE Kane (IRE),2015-2019,7,5,1,1,0,0,1,1 (1ct 0st),0.2,
37,S Keshvani (CAN),2010-2010,2,2,1,1,0,0,1,1 (1ct 0st),0.5,
38,RWT Key (ENG),2009-2009,1,1,1,1,0,0,1,1 (1ct 0st),1.0,
39,N Khanna (MALTA),2019-2019,2,2,1,1,0,0,1,1 (1ct 0st),0.5,
40,Khizer Ahmed (NOR),2019-2019,5,5,1,0,1,0,0,1 (0ct 1st),0.2,
41,N Khosla (MALTA),2019-2019,4,4,1,1,0,0,1,1 (1ct 0st),0.25,
42,Khurram Chohan (CAN),2010-2010,4,4,1,1,0,0,1,1 (1ct 0st),0.25,
43,TCR Kimber (GUE),2019-2019,3,3,1,0,1,0,0,1 (0ct 1st),0.33299999999999996,
44,NR Kirton (CAN),2019-2019,5,5,1,1,0,0,1,1 (1ct 0st),0.2,
45,RK Kleinveldt (SA),2008-2013,6,6,1,1,0,0,1,1 (1ct 0st),0.166,
46,Kuldeep Singh (PHI),2019-2019,4,4,1,1,0,0,1,1 (1ct 0st),0.25,
47,P Kumar (INDIA),2008-2012,10,10,1,1,0,0,1,1 (1ct 0st),0.1,
48,R Kumar (ROM),2019-2019,4,4,1,1,0,0,1,1 (1ct 0st),0.25,
49,UKPW Kumaranayaka (KUW),2019-2019,3,3,1,1,0,0,1,1 (1ct 0st),0.33299999999999996,
0,A Lagos (),2019-2019,1,1,1,1,0,0,1,1 (1ct 0st),1.0,
1,H Lakov (),2019-2019,3,3,1,1,0,0,1,1 (1ct 0st),0.33299999999999996,
2,CK Langeveldt (SA),2005-2010,9,9,1,1,0,0,1,1 (1ct 0st),0.111,
3,B Laughlin (AUS),2009-2013,3,3,1,1,0,0,1,1 (1ct 0st),0.33299999999999996,
4,J Lewis (ENG),2005-2007,2,2,1,1,0,0,1,1 (1ct 0st),0.5,
5,ML Lewis (AUS),2006-2006,2,2,1,1,0,0,1,1 (1ct 0st),0.5,
6,RN Lewis (WI),2008-2008,1,1,1,1,0,0,1,1 (1ct 0st),1.0,
7,NCK Liyanage (MAL),2019-2019,6,5,1,1,0,0,1,1 (1ct 0st),0.2,
8,KS Lokuarachchi (SL),2012-2012,2,2,1,1,0,0,1,1 (1ct 0st),0.5,
9,J Long (PHI),2019-2019,2,2,1,1,0,0,1,1 (1ct 0st),0.5,
10,T Lungameni (NAM),2019-2019,6,6,1,1,0,0,1,1 (1ct 0st),0.166,
11,GD McGrath (AUS),2005-2005,2,2,1,1,0,0,1,1 (1ct 0st),0.5,
12,NJ Maddinson (AUS),2013-2018,6,6,1,1,0,0,1,1 (1ct 0st),0.166,
13,DL Maddy (ENG),2007-2007,4,4,1,1,0,0,1,1 (1ct 0st),0.25,
14,Mahedi Hasan (BDESH),2018-2018,1,1,1,1,0,0,1,1 (1ct 0st),1.0,
15,Mahmad Data (PNM),2019-2019,2,2,1,1,0,0,1,1 (1ct 0st),0.5,
16,S Mahmood (ENG),2019-2019,3,3,1,1,0,0,1,1 (1ct 0st),0.33299999999999996,
17,SI Mahmood (ENG),2006-2009,4,4,1,1,0,0,1,1 (1ct 0st),0.25,
18,GI Maiden (SCOT),2008-2008,3,3,1,1,0,0,1,1 (1ct 0st),0.33299999999999996,
19,BF Mailata (Samoa),2019-2019,4,4,1,1,0,0,1,1 (1ct 0st),0.25,
20,GT Main (SCOT),2015-2016,4,2,1,1,0,0,1,1 (1ct 0st),0.5,
21,D Maisuria (Botsw),2019-2019,6,6,1,1,0,0,1,1 (1ct 0st),0.166,
22,A Makesh (KUW),2019-2019,4,4,1,1,0,0,1,1 (1ct 0st),0.25,
23,AK Mandal (NEPAL),2015-2015,2,2,1,1,0,0,1,1 (1ct 0st),0.5,
24,Mandeep Singh (INDIA),2016-2016,3,3,1,1,0,0,1,1 (1ct 0st),0.33299999999999996,
25,P Manning (Caym),2019-2019,6,6,1,1,0,0,1,1 (1ct 0st),0.166,
26,AK Markram (SA),2019-2019,2,2,1,1,0,0,1,1 (1ct 0st),0.5,
27,HJH Marshall (NZ),2005-2006,3,3,1,1,0,0,1,1 (1ct 0st),0.33299999999999996,
28,OM Marshall (Peru),2019-2019,3,3,1,1,0,0,1,1 (1ct 0st),0.33299999999999996,
29,CS Martin (NZ),2007-2008,6,6,1,1,0,0,1,1 (1ct 0st),0.166,
30,DR Martyn (AUS),2005-2006,4,4,1,1,0,0,1,1 (1ct 0st),0.25,
31,I Master (Botsw),2019-2019,2,2,1,1,0,0,1,1 (1ct 0st),0.5,
32,GE Mathurin (WI),2011-2012,3,3,1,1,0,0,1,1 (1ct 0st),0.33299999999999996,
33,B Mavuta (ZIM),2018-2018,3,3,1,1,0,0,1,1 (1ct 0st),0.33299999999999996,
34,M Meade (Chile),2019-2019,1,1,1,1,0,0,1,1 (1ct 0st),1.0,
35,SC Meaker (ENG),2012-2012,2,2,1,1,0,0,1,1 (1ct 0st),0.5,
36,J Mees (LUX),2019-2019,3,3,1,1,0,1,0,1 (1ct 0st),0.33299999999999996,
37,PHKD Mendis (SL),2018-2019,4,4,1,1,0,0,1,1 (1ct 0st),0.25,
38,CAJ Meschede (GER),2019-2019,5,5,1,1,0,0,1,1 (1ct 0st),0.2,
39,KO Meth (ZIM),2012-2012,2,2,1,1,0,0,1,1 (1ct 0st),0.5,
40,Mian Mehmood (PORT),2019-2019,4,4,1,1,0,0,1,1 (1ct 0st),0.25,
41,AJ Michael (Samoa),2019-2019,4,4,1,1,0,0,1,1 (1ct 0st),0.25,
42,TS Mills (ENG/ICC),2016-2018,5,5,1,1,0,0,1,1 (1ct 0st),0.2,
43,A Mishra (INDIA),2010-2017,10,10,1,1,0,0,1,1 (1ct 0st),0.1,
44,P Mishra (),2019-2019,3,3,1,1,0,0,1,1 (1ct 0st),0.33299999999999996,
45,K Modise (Botsw),2019-2019,3,3,1,1,0,0,1,1 (1ct 0st),0.33299999999999996,
46,Mohammad Irfan (PAK),2012-2019,22,22,1,1,0,0,1,1 (1ct 0st),0.045,
47,Mohammad Kashif (NL),2010-2010,3,3,1,1,0,0,1,1 (1ct 0st),0.33299999999999996,
48,Mohammad Shahzad (UAE),2015-2017,20,20,1,1,0,0,1,1 (1ct 0st),0.05,
49,Mohammad Tauqir (UAE),2015-2015,3,3,1,1,0,0,1,1 (1ct 0st),0.33299999999999996,
0,Mohammad Yousuf (PAK),2006-2010,3,3,1,1,0,0,1,1 (1ct 0st),0.33299999999999996,
1,JN Mohammed (WI),2017-2018,9,9,1,1,0,0,1,1 (1ct 0st),0.111,
2,Mohammed Qasim (UAE),2016-2017,3,3,1,1,0,0,1,1 (1ct 0st),0.33299999999999996,
3,Mohammed Siraj (INDIA),2017-2018,3,3,1,1,0,0,1,1 (1ct 0st),0.33299999999999996,
4,HJC Mol (NL),2008-2008,4,3,1,1,0,0,1,1 (1ct 0st),0.33299999999999996,
5,Mominul Haque (BDESH),2012-2014,6,6,1,1,0,0,1,1 (1ct 0st),0.166,
6,D Mongia (INDIA),2006-2006,1,1,1,1,0,0,1,1 (1ct 0st),1.0,
7,M Mooketsi (Botsw),2019-2019,7,7,1,1,0,0,1,1 (1ct 0st),0.142,
8,Mudassar Muhammad (GER),2019-2019,7,7,1,1,0,0,1,1 (1ct 0st),0.142,
9,Muhamad Syahadat (MAL),2019-2019,10,9,1,1,0,0,1,1 (1ct 0st),0.111,
10,Muhammad Amir (MAL),2019-2019,1,1,1,1,0,0,1,1 (1ct 0st),1.0,
11,Muhammad Asjed (ESP),2019-2019,2,2,1,1,0,0,1,1 (1ct 0st),0.5,
12,Muhammad Kaleem (UAE),2016-2016,9,9,1,1,0,0,1,1 (1ct 0st),0.111,
13,Muhammad Khurram (MWI),2019-2019,5,5,1,1,0,1,0,1 (1ct 0st),0.2,
14,Muhammad Naeem (Saudi),2019-2019,5,5,1,1,0,0,1,1 (1ct 0st),0.2,
15,Muhammad Saleem (),2019-2019,4,4,1,1,0,0,1,1 (1ct 0st),0.25,
16,JK Mukhiya (NEPAL),2014-2015,4,4,1,1,0,0,1,1 (1ct 0st),0.25,
17,EMDY Munaweera (SL),2012-2017,13,13,1,1,0,0,1,1 (1ct 0st),0.076,
18,GBW Munaweera (QAT),2019-2019,5,5,1,1,0,0,1,1 (1ct 0st),0.2,
19,Munir Dar (HKG),2014-2014,2,2,1,1,0,0,1,1 (1ct 0st),0.5,
20,M Muralitharan (SL),2006-2010,12,12,1,1,0,0,1,1 (1ct 0st),0.083,
21,D Murphy (SCOT),2013-2013,4,4,1,1,0,1,0,1 (1ct 0st),0.25,
22,Musawar Shah (QAT),2019-2019,2,2,1,1,0,0,1,1 (1ct 0st),0.5,
23,N M'shangwe (ZIM),2013-2014,5,5,1,1,0,0,1,1 (1ct 0st),0.2,
24,AK Muslar (Blz),2019-2019,3,3,1,1,0,0,1,1 (1ct 0st),0.33299999999999996,
25,Muslim Yar (GER),2019-2019,7,7,1,1,0,0,1,1 (1ct 0st),0.142,
26,T Muzarabani (ZIM),2015-2016,9,9,1,1,0,0,1,1 (1ct 0st),0.111,
27,M Mwamadi (MWI),2019-2019,3,3,1,1,0,0,1,1 (1ct 0st),0.33299999999999996,
28,Najjam Shahzad (PORT),2019-2019,4,4,1,1,0,0,1,1 (1ct 0st),0.25,
29,DM Nakrani (UGA),2019-2019,4,4,1,1,0,0,1,1 (1ct 0st),0.25,
30,W Nalisa (VAN),2019-2019,9,9,1,1,0,0,1,1 (1ct 0st),0.111,
31,DP Nannes (AUS/NL),2009-2010,17,17,1,1,0,0,1,1 (1ct 0st),0.057999999999999996,
32,Naseem Khushi (OMAN),2017-2019,10,10,1,1,0,0,1,1 (1ct 0st),0.1,
33,A Nathwani (Aut),2019-2019,5,5,1,1,0,0,1,1 (1ct 0st),0.2,
34,A Natubhai Ahir (PNM),2019-2019,3,3,1,1,0,0,1,1 (1ct 0st),0.33299999999999996,
35,Naveed Ahmed (CZK-R),2019-2019,7,7,1,1,0,0,1,1 (1ct 0st),0.142,
36,Nazakat Ali (NOR),2019-2019,2,2,1,1,0,0,1,1 (1ct 0st),0.5,
37,Nazril Rahman (MAL),2019-2019,7,7,1,1,0,0,1,1 (1ct 0st),0.142,
38,A Nel (SA),2005-2007,2,2,1,1,0,0,1,1 (1ct 0st),0.5,
39,JD Nel (SCOT),2007-2010,10,9,1,1,0,0,1,1 (1ct 0st),0.111,
40,L Ngidi (SA),2017-2018,7,7,1,1,0,0,1,1 (1ct 0st),0.142,
41,PA Nixon (ENG),2007-2007,1,1,1,0,1,0,0,1 (0ct 1st),1.0,
42,L Nussbaumer (GUE),2019-2019,1,1,1,1,0,0,1,1 (1ct 0st),1.0,
43,SH Obed (VAN),2019-2019,12,12,1,1,0,0,1,1 (1ct 0st),0.083,
44,E Ochieng (KENYA),2019-2019,2,2,1,1,0,0,1,1 (1ct 0st),0.5,
45,PP Ojha (INDIA),2009-2010,6,6,1,1,0,0,1,1 (1ct 0st),0.166,
46,SNJ O'Keefe (AUS),2010-2011,7,7,1,1,0,0,1,1 (1ct 0st),0.142,
47,IO Okpe (NGA),2019-2019,8,8,1,1,0,0,1,1 (1ct 0st),0.125,
48,R Olipa (UGA),2019-2019,2,2,1,1,0,0,1,1 (1ct 0st),0.5,
49,Omar Hayat (DEN),2019-2019,2,2,1,1,0,0,1,1 (1ct 0st),0.5,
0,A Otwani (UGA),2019-2019,4,4,1,1,0,1,0,1 (1ct 0st),0.25,
1,SD Outerbridge (BMUDA),2008-2008,3,3,1,1,0,0,1,1 (1ct 0st),0.33299999999999996,
2,E Packard (GIBR),2019-2019,4,4,1,1,0,0,1,1 (1ct 0st),0.25,
3,K Pala (PNG),2015-2015,2,2,1,1,0,0,1,1 (1ct 0st),0.5,
4,I Pandey (NEPAL),2019-2019,4,4,1,1,0,0,1,1 (1ct 0st),0.25,
5,NMS Param (SGP),2019-2019,8,8,1,1,0,0,1,1 (1ct 0st),0.125,
6,PA Patel (INDIA),2011-2011,2,2,1,1,0,1,0,1 (1ct 0st),0.5,
7,RN Patel (KENYA),2019-2019,2,2,1,1,0,0,1,1 (1ct 0st),0.5,
8,D Paterson (SA),2017-2018,8,8,1,1,0,0,1,1 (1ct 0st),0.125,
9,C Pengkumta (THAI),2019-2019,4,4,1,1,0,0,1,1 (1ct 0st),0.25,
10,AK Perera (SL),2013-2019,6,6,1,1,0,0,1,1 (1ct 0st),0.166,
11,SL Perera (Ghana),2019-2019,2,2,1,1,0,0,1,1 (1ct 0st),0.5,
12,WKD Perkins (WI),2008-2008,1,1,1,1,0,0,1,1 (1ct 0st),1.0,
13,J Perman (ESP),2019-2019,2,2,1,1,0,0,1,1 (1ct 0st),0.5,
14,AN Petersen (SA),2010-2010,2,2,1,1,0,0,1,1 (1ct 0st),0.5,
15,VD Philander (SA),2007-2007,7,7,1,1,0,0,1,1 (1ct 0st),0.142,
16,K Pierre (WI),2018-2019,8,8,1,1,0,0,1,1 (1ct 0st),0.125,
17,R Pillai (GER),2019-2019,6,6,1,1,0,0,1,1 (1ct 0st),0.166,
18,R Pisal (ROM),2019-2019,1,1,1,1,0,0,1,1 (1ct 0st),1.0,
19,S Pokhriyal (CZK-R),2019-2019,5,5,1,1,0,0,1,1 (1ct 0st),0.2,
20,KOA Powell (WI),2014-2014,1,1,1,1,0,0,1,1 (1ct 0st),1.0,
21,M Pushpakumara (SL),2009-2009,1,1,1,1,0,0,1,1 (1ct 0st),1.0,
22,A Rangaswamy (Botsw),2019-2019,4,4,1,1,0,0,1,1 (1ct 0st),0.25,
23,Raqibul Hasan (BDESH),2008-2010,5,5,1,1,0,0,1,1 (1ct 0st),0.2,
24,Raza Iqbal (NOR),2019-2019,5,5,1,1,0,0,1,1 (1ct 0st),0.2,
25,CMW Read (ENG),2006-2006,1,1,1,1,0,1,0,1 (1ct 0st),1.0,
26,FL Reifer (WI),2009-2009,1,1,1,1,0,0,1,1 (1ct 0st),1.0,
27,JB Reva (PNG),2015-2019,9,9,1,1,0,0,1,1 (1ct 0st),0.111,
28,KAJ Roach (WI),2008-2012,11,11,1,1,0,0,1,1 (1ct 0st),0.09,
29,IH Romaine (BMUDA),2008-2008,2,2,1,1,0,0,1,1 (1ct 0st),0.5,
30,Rubel Hossain (BDESH),2009-2018,27,26,1,1,0,0,1,1 (1ct 0st),0.038,
31,Rumman Raees (PAK),2016-2018,8,8,1,1,0,0,1,1 (1ct 0st),0.125,
32,RJMGM Rupasinghe (SL),2009-2009,2,2,1,1,0,0,1,1 (1ct 0st),0.5,
33,GR Russ (PHI),2019-2019,3,3,1,1,0,0,1,1 (1ct 0st),0.33299999999999996,
34,HD Rutherford (NZ),2013-2019,8,8,1,1,0,0,1,1 (1ct 0st),0.125,
35,SE Rutherford (WI),2018-2019,3,3,1,1,0,0,1,1 (1ct 0st),0.33299999999999996,
36,Saad Nasim (PAK),2014-2014,3,3,1,1,0,0,1,1 (1ct 0st),0.33299999999999996,
37,VM Sachdev (PNM),2019-2019,2,2,1,1,0,0,1,1 (1ct 0st),0.5,
38,Sadeeq Khan (ROM),2019-2019,3,3,1,1,0,0,1,1 (1ct 0st),0.33299999999999996,
39,Sahir Naqash (GER),2019-2019,7,7,1,1,0,0,1,1 (1ct 0st),0.142,
40,NA Saini (INDIA),2019-2019,5,5,1,1,0,0,1,1 (1ct 0st),0.2,
41,Sajedul Islam (BDESH),2013-2013,1,1,1,1,0,0,1,1 (1ct 0st),1.0,
42,AM Samad (CAN),2008-2010,7,7,1,1,0,0,1,1 (1ct 0st),0.142,
43,SV Samson (INDIA),2015-2015,1,1,1,1,0,0,1,1 (1ct 0st),1.0,
44,R Sandaruwan (KUW),2019-2019,10,10,1,1,0,0,1,1 (1ct 0st),0.1,
45,JRMVB Sanjaya (SL),2017-2017,8,8,1,1,0,0,1,1 (1ct 0st),0.125,
46,K Santokie (WI),2011-2014,12,12,1,1,0,0,1,1 (1ct 0st),0.083,
47,Saqlain Arshad (QAT),2019-2019,2,2,1,1,0,0,1,1 (1ct 0st),0.5,
48,M Sarenac (Serb),2019-2019,2,2,1,1,0,0,1,1 (1ct 0st),0.5,
49,A Sarma (GER),2019-2019,3,3,1,1,0,0,1,1 (1ct 0st),0.33299999999999996,
0,MM Sarwar (KUW),2019-2019,5,5,1,1,0,0,1,1 (1ct 0st),0.2,
1,I Sawmy (DEN),2019-2019,2,2,1,1,0,0,1,1 (1ct 0st),0.5,
2,Sayed Shirzad (AFG),2015-2019,4,4,1,1,0,0,1,1 (1ct 0st),0.25,
3,CP Schofield (ENG),2007-2007,4,4,1,1,0,0,1,1 (1ct 0st),0.25,
4,Shaffeq Muhammad (),2019-2019,2,2,1,1,0,0,1,1 (1ct 0st),0.5,
5,Shafiul Islam (BDESH),2010-2019,17,17,1,1,0,0,1,1 (1ct 0st),0.057999999999999996,
6,Shaheen Shah Afridi (PAK),2018-2019,10,10,1,1,0,0,1,1 (1ct 0st),0.1,
7,Shaheryar Butt (Belg),2019-2019,3,3,1,1,0,0,1,1 (1ct 0st),0.33299999999999996,
8,Shahid Wasif (HKG),2016-2019,9,9,1,1,0,0,1,1 (1ct 0st),0.111,
9,Shahriar Nafees (BDESH),2006-2006,1,1,1,1,0,0,1,1 (1ct 0st),1.0,
10,A Shahzad (ENG),2010-2011,3,3,1,1,0,0,1,1 (1ct 0st),0.33299999999999996,
11,Shamsudheen Purat (Saudi),2019-2019,3,3,1,1,0,0,1,1 (1ct 0st),0.33299999999999996,
12,JNK Shannon (IRE),2013-2018,8,8,1,1,0,0,1,1 (1ct 0st),0.125,
13,Sharafuddin Ashraf (AFG),2015-2019,8,8,1,1,0,0,1,1 (1ct 0st),0.125,
14,MM Sharma (INDIA),2014-2015,8,8,1,1,0,0,1,1 (1ct 0st),0.125,
15,V Shetty (UAE),2014-2014,2,2,1,1,0,0,1,1 (1ct 0st),0.5,
16,Shoaib Khan jnr (PAK),2008-2008,4,4,1,1,0,0,1,1 (1ct 0st),0.25,
17,Shuvagata Hom (BDESH),2016-2016,5,5,1,1,0,0,1,1 (1ct 0st),0.2,
18,EHSN Silva (UAE),2014-2014,2,2,1,1,0,0,1,1 (1ct 0st),0.5,
19,KRP Silva (USA),2019-2019,2,2,1,1,0,0,1,1 (1ct 0st),0.5,
20,M Simpson-Parker (Aut),2019-2019,3,3,1,1,0,0,1,1 (1ct 0st),0.33299999999999996,
21,J Singye (BHU),2019-2019,2,2,1,1,0,0,1,1 (1ct 0st),0.5,
22,DS Smith (WI),2007-2009,6,6,1,1,0,0,1,1 (1ct 0st),0.166,
23,SJS Smith (SCOT),2010-2012,5,5,1,0,1,0,0,1 (0ct 1st),0.2,
24,J Smits (NL),2008-2009,6,5,1,1,0,1,0,1 (1ct 0st),0.2,
25,JT Smuts (SA),2017-2018,8,8,1,1,0,0,1,1 (1ct 0st),0.125,
26,JN Snape (ENG),2007-2007,1,1,1,1,0,0,1,1 (1ct 0st),1.0,
27,CB Sole (SCOT),2017-2018,4,4,1,1,0,0,1,1 (1ct 0st),0.25,
28,A Srivastav (Chile),2019-2019,4,4,1,1,0,0,1,1 (1ct 0st),0.25,
29,ACF Stokes (GUE),2019-2019,7,7,1,1,0,0,1,1 (1ct 0st),0.142,
30,AJ Strauss (ENG),2005-2009,4,4,1,1,0,0,1,1 (1ct 0st),0.25,
31,R Strydom (IRE),2008-2008,4,3,1,1,0,0,1,1 (1ct 0st),0.33299999999999996,
32,Sufyan Mehmood (OMAN),2015-2019,3,3,1,1,0,0,1,1 (1ct 0st),0.33299999999999996,
33,P Syafiq Ali (MAL),2019-2019,2,1,1,1,0,0,1,1 (1ct 0st),1.0,
34,Syed Rasel (BDESH),2007-2008,8,8,1,1,0,0,1,1 (1ct 0st),0.125,
35,Tanveer Ahmed (HKG),2016-2017,5,5,1,1,0,0,1,1 (1ct 0st),0.2,
36,Taskin Ahmed (BDESH),2014-2018,19,17,1,1,0,0,1,1 (1ct 0st),0.057999999999999996,
37,P Taylor (CZK-R),2019-2019,7,7,1,1,0,0,1,1 (1ct 0st),0.142,
38,T Taylor (Caym),2019-2019,6,6,1,1,0,0,1,1 (1ct 0st),0.166,
39,SR Tendulkar (INDIA),2006-2006,1,1,1,1,0,0,1,1 (1ct 0st),1.0,
40,SP Terry (IRE),2016-2016,1,1,1,1,0,0,1,1 (1ct 0st),1.0,
41,DC Thomas (WI),2009-2013,3,3,1,0,1,0,0,1 (0ct 1st),0.33299999999999996,
42,S Tobgay (BHU),2019-2019,2,2,1,1,0,0,1,1 (1ct 0st),0.5,
43,GC Tonge (WI),2009-2009,1,1,1,1,0,0,1,1 (1ct 0st),1.0,
44,RJW Topley (ENG),2015-2016,6,6,1,1,0,0,1,1 (1ct 0st),0.166,
45,A Tripathi (Mex),2019-2019,3,3,1,1,0,0,1,1 (1ct 0st),0.33299999999999996,
46,LL Tsotsobe (SA),2009-2014,23,23,1,1,0,0,1,1 (1ct 0st),0.043,
47,JJ Tucker (BMUDA),2019-2019,5,5,1,1,0,0,1,1 (1ct 0st),0.2,
48,S Tyagi (INDIA),2009-2009,1,1,1,1,0,0,1,1 (1ct 0st),1.0,
49,A Uniyal (Chile),2019-2019,3,3,1,1,0,0,1,1 (1ct 0st),0.33299999999999996,
0,Usama Master (MWI),2019-2019,6,6,1,1,0,0,1,1 (1ct 0st),0.166,
1,Usman Ali (Saudi),2019-2019,5,5,1,1,0,0,1,1 (1ct 0st),0.2,
2,Usman Limbada (CAN),2010-2013,7,7,1,1,0,0,1,1 (1ct 0st),0.142,
3,Usman Shinwari (PAK),2013-2019,16,16,1,1,0,0,1,1 (1ct 0st),0.062,
4,Usman Waheed (KUW),2019-2019,6,6,1,1,0,0,1,1 (1ct 0st),0.166,
5,JDF Vandersay (SL),2015-2019,10,10,1,1,0,0,1,1 (1ct 0st),0.1,
6,MB van Schelven (NL),2015-2015,2,2,1,1,0,0,1,1 (1ct 0st),0.5,
7,TCW Veillard (GUE),2019-2019,4,4,1,1,0,0,1,1 (1ct 0st),0.25,
8,S Vijayakumar (SGP),2019-2019,9,9,1,1,0,0,1,1 (1ct 0st),0.111,
9,Vimal Kumar (PHI),2019-2019,2,2,1,1,0,0,1,1 (1ct 0st),0.5,
10,R Vinay Kumar (INDIA),2010-2013,9,9,1,1,0,0,1,1 (1ct 0st),0.111,
11,L Vincent (NZ),2006-2007,9,9,1,1,0,0,1,1 (1ct 0st),0.111,
12,W Viraliliu (VAN),2019-2019,10,10,1,1,0,0,1,1 (1ct 0st),0.1,
13,Vishal Ahir (PNM),2019-2019,1,1,1,1,0,0,1,1 (1ct 0st),1.0,
14,KDK Vithanage (SL),2014-2016,3,3,1,1,0,0,1,1 (1ct 0st),0.33299999999999996,
15,Waqar Khan (Peru),2019-2019,4,4,1,1,0,0,1,1 (1ct 0st),0.25,
16,Waqas Ali (Belg),2019-2019,2,2,1,1,0,0,1,1 (1ct 0st),0.5,
17,Washeem Abbas (MALTA),2019-2019,2,2,1,1,0,0,1,1 (1ct 0st),0.5,
18,VS Wategaonkar (OMAN),2016-2016,2,2,1,1,0,0,1,1 (1ct 0st),0.5,
19,RM West (IRE),2009-2009,5,5,1,1,0,0,1,1 (1ct 0st),0.2,
20,AA Westphal (Mex),2019-2019,5,5,1,1,0,0,1,1 (1ct 0st),0.2,
21,BTJ Wheal (SCOT),2016-2017,5,5,1,1,0,0,1,1 (1ct 0st),0.2,
22,BM Wheeler (NZ),2017-2018,6,6,1,1,0,0,1,1 (1ct 0st),0.166,
23,S Wickramasekara (CZK-R),2019-2019,5,5,1,1,0,0,1,1 (1ct 0st),0.2,
24,SA Wijeyeratne (CAN),2019-2019,2,2,1,1,0,0,1,1 (1ct 0st),0.5,
25,JD Wildermuth (AUS),2018-2018,2,2,1,1,0,0,1,1 (1ct 0st),0.5,
26,CR Woakes (ENG),2011-2015,8,8,1,1,0,0,1,1 (1ct 0st),0.125,
27,LJ Woodcock (NZ),2010-2011,3,3,1,1,0,0,1,1 (1ct 0st),0.33299999999999996,
28,GH Worker (NZ),2015-2015,2,2,1,1,0,0,1,1 (1ct 0st),0.5,
29,AS Wright (GUE),2019-2019,8,8,1,1,0,0,1,1 (1ct 0st),0.125,
30,CM Wright (SCOT),2007-2009,3,2,1,1,0,0,1,1 (1ct 0st),0.5,
31,HN Ya France (NAM),2019-2019,6,6,1,1,0,0,1,1 (1ct 0st),0.166,
32,Yasar Idrees (KUW),2019-2019,1,1,1,1,0,0,1,1 (1ct 0st),1.0,
33,Yasir Arafat (PAK),2007-2012,13,13,1,1,0,0,1,1 (1ct 0st),0.076,
34,Zaheer Maqsood (UAE),2015-2016,3,3,1,1,0,0,1,1 (1ct 0st),0.33299999999999996,
35,Zahid Hussain (CAN),2012-2012,3,3,1,1,0,0,1,1 (1ct 0st),0.33299999999999996,
36,Zameer Khan (DEN),2019-2019,2,2,1,1,0,0,1,1 (1ct 0st),0.5,
37,A Zampa (AUS),2016-2019,27,26,1,1,0,0,1,1 (1ct 0st),0.038,
38,C Zavoiu (ROM),2019-2019,3,3,1,1,0,0,1,1 (1ct 0st),0.33299999999999996,
39,Zawar Farid (UAE),2019-2019,4,4,1,1,0,0,1,1 (1ct 0st),0.25,
40,Zeeshan Abbas (BAH),2019-2019,1,1,1,1,0,0,1,1 (1ct 0st),1.0,
41,Zubaidi Zulkifle (MAL),2019-2019,4,4,1,1,0,0,1,1 (1ct 0st),0.25,
42,Zulfiqar Babar (PAK),2013-2014,7,7,1,1,0,0,1,1 (1ct 0st),0.142,
43,Zulqarnain Haider (PAK),2007-2010,3,3,1,0,1,0,0,1 (0ct 1st),0.33299999999999996,
44,Zulqarnain Haider (ESP),2019-2019,5,5,1,1,0,0,1,1 (1ct 0st),0.2,
45,Aamer Ikram (PORT),2019-2019,4,4,0,0,0,0,0,0,0.0,
46,Aamer Yamin (PAK),2015-2018,2,2,0,0,0,0,0,0,0.0,
47,Aaron Jones (USA),2019-2019,8,8,0,0,0,0,0,0,0.0,
48,Z Abbasi (Botsw),2019-2019,1,1,0,0,0,0,0,0,0.0,
49,Abbas Saad (Saudi),2019-2019,2,2,0,0,0,0,0,0,0.0,
0,YA Abdulla (SA),2009-2009,2,2,0,0,0,0,0,0,0.0,
1,Abdullah Mahmood (DEN),2019-2019,1,1,0,0,0,0,0,0,0.0,
2,Abdullah Sheikh (NOR),2019-2019,2,2,0,0,0,0,0,0,0.0,
3,Abdul Rashid (Belg),2019-2019,1,1,0,0,0,0,0,0,0.0,
4,Abdur Rauf (PAK),2008-2008,1,1,0,0,0,0,0,0,0.0,
5,M Aboagye (Ghana),2019-2019,3,3,0,0,0,0,0,0,0.0,
6,RA Abolarin (NGA),2019-2019,1,1,0,0,0,0,0,0,0.0,
7,Abul Hasan (BDESH),2012-2018,5,5,0,0,0,0,0,0,0.0,
8,AG Achar (SGP),2019-2019,3,3,0,0,0,0,0,0,0.0,
9,F Achelam (UGA),2019-2019,1,1,0,0,0,0,0,0,0.0,
10,Adil Hanif (BAH),2019-2019,4,4,0,0,0,0,0,0,0.0,
11,Adnan Mufti (UAE),2017-2017,1,1,0,0,0,0,0,0,0.0,
12,N Advani (GIBR),2019-2019,1,1,0,0,0,0,0,0,0.0,
13,Aftab Ahmed (2) (DEN),2019-2019,1,1,0,0,0,0,0,0,0.0,
14,AB Agarkar (INDIA),2006-2007,4,3,0,0,0,0,0,0,0.0,
15,A Ahmadhel (),2019-2019,3,3,0,0,0,0,0,0,0.0,
16,RI Ahmed (NL),2015-2015,2,2,0,0,0,0,0,0,0.0,
17,Ahmed Wardak (GER),2019-2019,9,9,0,0,0,0,0,0,0.0,
18,Ahsan Abbasi (HKG),2019-2019,6,6,0,0,0,0,0,0,0.0,
19,Ainool Hafizs (MAL),2019-2019,3,3,0,0,0,0,0,0,0.0,
20,Aizaz Cheema (PAK),2011-2012,5,5,0,0,0,0,0,0,0.0,
21,D Ajekun (NGA),2019-2019,6,6,0,0,0,0,0,0,0.0,
22,C Akyuz (TKY),2019-2019,2,2,0,0,0,0,0,0,0.0,
23,Ali Ivan (Mald),2019-2019,1,1,0,0,0,0,0,0,0.0,
24,Ali Naqi (PORT),2019-2019,4,4,0,0,0,0,0,0,0.0,
25,J Allen (),2019-2019,2,2,0,0,0,0,0,0,0.0,
26,HS Alta (TKY),2019-2019,4,4,0,0,0,0,0,0,0.0,
27,Ameel Mauroof (Mald),2019-2019,10,10,0,0,0,0,0,0,0.0,
28,Ameer Saiyed (Botsw),2019-2019,4,4,0,0,0,0,0,0,0.0,
29,Aminul Islam (BDESH),2019-2019,4,4,0,0,0,0,0,0,0.0,
30,Amir Hayat (UAE),2018-2019,4,4,0,0,0,0,0,0,0.0,
31,Amir Hamza (AFG),2013-2017,31,31,0,0,0,0,0,0,0.0,
32,Ammad Uddin (BAH),2019-2019,4,4,0,0,0,0,0,0,0.0,
33,Anas Khan (HKG),2014-2014,1,1,0,0,0,0,0,0,0.0,
34,J Anderson (IRE),2015-2015,4,2,0,0,0,0,0,0,0.0,
35,DK Anefie (Ghana),2019-2019,4,4,0,0,0,0,0,0,0.0,
36,A Anemogiannis (),2019-2019,1,1,0,0,0,0,0,0,0.0,
37,B Angeltti (Arg),2019-2019,3,3,0,0,0,0,0,0,0.0,
38,DNA Ankrah (Ghana),2019-2019,4,4,0,0,0,0,0,0,0.0,
39,M Ansari (OMAN),2015-2016,11,10,0,0,0,0,0,0,0.0,
40,Ansar Iqbal (NOR),2019-2019,4,4,0,0,0,0,0,0,0.0,
41,MA Aponso (SL),2018-2018,3,3,0,0,0,0,0,0,0.0,
42,Apon Mustafizur (Serb),2019-2019,2,2,0,0,0,0,0,0,0.0,
43,S Appu (MALTA),2019-2019,4,4,0,0,0,0,0,0,0.0,
44,S Aravind (INDIA),2015-2015,1,1,0,0,0,0,0,0,0.0,
45,JC Archer (ENG),2019-2019,1,1,0,0,0,0,0,0,0.0,
46,Z Arinaitwe (UGA),2019-2019,3,3,0,0,0,0,0,0,0.0,
47,RP Arnold (SL),2006-2006,1,1,0,0,0,0,0,0,0.0,
48,B Arora (MALTA),2019-2019,4,4,0,0,0,0,0,0,0.0,
49,Arsalan Arif (Aut),2019-2019,2,2,0,0,0,0,0,0,0.0,
0,Arsalan Qadir (CAN),2010-2010,1,1,0,0,0,0,0,0,0.0,
1,Arshad Hayat (CZK-R),2019-2019,6,6,0,0,0,0,0,0,0.0,
2,Arslan Ahmed (PORT),2019-2019,3,3,0,0,0,0,0,0,0.0,
3,Arslan Ahmed (),2019-2019,3,3,0,0,0,0,0,0,0.0,
4,Asad Ali (PAK),2013-2013,2,2,0,0,0,0,0,0,0.0,
5,A Aspiotis (),2019-2019,3,3,0,0,0,0,0,0,0.0,
6,MS Atapattu (SL),2006-2006,2,2,0,0,0,0,0,0,0.0,
7,S Ateak (Ghana),2019-2019,3,3,0,0,0,0,0,0,0.0,
8,Atif Ali Khan (UAE),2016-2016,1,1,0,0,0,0,0,0,0.0,
9,Atif Mehmood (ESP),2019-2019,9,9,0,0,0,0,0,0,0.0,
10,R Avery (),2019-2019,4,4,0,0,0,0,0,0,0.0,
11,Awais Zia (PAK),2012-2014,5,5,0,0,0,0,0,0,0.0,
12,P Awana (INDIA),2012-2012,2,2,0,0,0,0,0,0,0.0,
13,Aziz Mohammad (Belg),2019-2019,3,3,0,0,0,0,0,0,0.0,
14,Azyan Farhath (Mald),2019-2019,2,2,0,0,0,0,0,0,0.0,
15,S Badrinath (INDIA),2011-2011,1,1,0,0,0,0,0,0,0.0,
16,LS Baker (WI),2008-2009,3,3,0,0,0,0,0,0,0.0,
17,R Bakum (Ghana),2019-2019,4,4,0,0,0,0,0,0,0.0,
18,L Balaji (INDIA),2012-2012,5,5,0,0,0,0,0,0,0.0,
19,KMC Bandara (SL),2016-2016,1,1,0,0,0,0,0,0,0.0,
20,HH Banner (Blz),2019-2019,3,3,0,0,0,0,0,0,0.0,
21,TC Barker (LUX),2019-2019,4,4,0,0,0,0,0,0,0.0,
22,MC Bascombe (WI),2011-2011,1,1,0,0,0,0,0,0,0.0,
23,Bashir Shah (DEN),2019-2019,4,4,0,0,0,0,0,0,0.0,
24,TC Bastiampillai (CAN),2010-2010,2,2,0,0,0,0,0,0,0.0,
25,MD Bates (NZ),2012-2012,3,3,0,0,0,0,0,0,0.0,
26,GJ Batty (ENG),2009-2009,1,1,0,0,0,0,0,0,0.0,
27,D Bau (PNG),2017-2017,1,1,0,0,0,0,0,0,0.0,
28,CS Baugh (WI),2008-2012,3,3,0,0,0,0,0,0,0.0,
29,DE Bernard (WI),2009-2009,1,1,0,0,0,0,0,0,0.0,
30,TL Best (WI),2013-2014,6,6,0,0,0,0,0,0,0.0,
31,P Bharat Patel (PNM),2019-2019,2,2,0,0,0,0,0,0,0.0,
32,S Bhari (NEPAL),2019-2019,6,6,0,0,0,0,0,0,0.0,
33,P Bhart (NOR),2019-2019,5,5,0,0,0,0,0,0,0.0,
34,A Bhattarai (NEPAL),2014-2014,1,1,0,0,0,0,0,0,0.0,
35,U Bhatti (CAN),2008-2010,7,7,0,0,0,0,0,0,0.0,
36,Bilal Ahmed (Serb),2019-2019,1,1,0,0,0,0,0,0,0.0,
37,IS Billcliff (CAN),2010-2010,2,2,0,0,0,0,0,0,0.0,
38,STR Binny (INDIA),2015-2016,3,3,0,0,0,0,0,0,0.0,
39,K Birkenstock (NAM),2019-2019,4,4,0,0,0,0,0,0,0.0,
40,KK Bishnoi (),2019-2019,3,3,0,0,0,0,0,0,0.0,
41,CC Blake (VAN),2019-2019,3,3,0,0,0,0,0,0,0.0,
42,AM Blignaut (ZIM),2010-2010,1,1,0,0,0,0,0,0,0.0,
43,GH Bodi (SA),2007-2007,1,1,0,0,0,0,0,0,0.0,
44,N Boje (SA),2005-2005,1,1,0,0,0,0,0,0,0.0,
45,NE Bonner (WI),2011-2012,2,2,0,0,0,0,0,0,0.0,
46,CJ Boyce (AUS),2014-2016,7,7,0,0,0,0,0,0,0.0,
47,TS Braat (NL),2019-2019,3,3,0,0,0,0,0,0,0.0,
48,DL Brangman (BMUDA),2019-2019,5,5,0,0,0,0,0,0,0.0,
49,DR Brown (SCOT),2007-2007,2,1,0,0,0,0,0,0,0.0,
0,P Buccimazza (PORT),2019-2019,4,4,0,0,0,0,0,0,0.0,
1,NB Budayair (NEPAL),2014-2014,4,4,0,0,0,0,0,0,0.0,
2,A Bulow (DEN),2019-2019,2,1,0,0,0,0,0,0,0.0,
3,CG Burnett (SCOT),2013-2013,1,1,0,0,0,0,0,0,0.0,
4,S Byrne (MALTA),2019-2019,2,2,0,0,0,0,0,0,0.0,
5,G Caisley (),2019-2019,4,4,0,0,0,0,0,0,0.0,
6,HL Carlyon (JER),2019-2019,9,9,0,0,0,0,0,0,0.0,
7,A Carthew (Chile),2019-2019,4,4,0,0,0,0,0,0,0.0,
8,T Caruana (GIBR),2019-2019,2,2,0,0,0,0,0,0,0.0,
9,D Cato (Caym),2019-2019,3,3,0,0,0,0,0,0,0.0,
10,JJ Celestine (BMUDA),2008-2008,3,3,0,0,0,0,0,0,0.0,
11,DL Chahar (INDIA),2018-2019,10,10,0,0,0,0,0,0,0.0,
12,RD Chahar (INDIA),2019-2019,1,1,0,0,0,0,0,0,0.0,
13,Charanjeet Singh (ITA),2019-2019,3,2,0,0,0,0,0,0,0.0,
14,G Chaturvedi (MALTA),2019-2019,2,2,0,0,0,0,0,0,0.0,
15,M Chauhan (Fin),2019-2019,2,2,0,0,0,0,0,0,0.0,
16,VB Chikkannaiah (GER),2019-2019,7,7,0,0,0,0,0,0,0.0,
17,Chirag Suri (UAE),2018-2019,7,7,0,0,0,0,0,0,0.0,
18,S Chophel (BHU),2019-2019,1,1,0,0,0,0,0,0,0.0,
19,DO Christian (WI),2011-2011,2,2,0,0,0,0,0,0,0.0,
20,I Civric (Serb),2019-2019,1,1,0,0,0,0,0,0,0.0,
21,GL Cloete (SA),2018-2019,2,2,0,0,0,0,0,0,0.0,
22,FRJ Coleman (SCOT),2013-2013,1,1,0,0,0,0,0,0,0.0,
23,NG Collins (Fin),2019-2019,5,5,0,0,0,0,0,0,0.0,
24,MNR Cooray (Mald),2019-2019,4,4,0,0,0,0,0,0,0.0,
25,M Cope (LUX),2019-2019,2,2,0,0,0,0,0,0,0.0,
26,SJ Cotter (Samoa),2019-2019,4,4,0,0,0,0,0,0,0.0,
27,MS Crane (ENG),2017-2017,2,2,0,0,0,0,0,0,0.0,
28,SM Curran (ENG),2019-2019,5,5,0,0,0,0,0,0,0.0,
29,D Daesrath (CAN),2013-2013,1,1,0,0,0,0,0,0,0.0,
30,H Dajc (Serb),2019-2019,2,2,0,0,0,0,0,0,0.0,
31,S Dalton (CZK-R),2019-2019,3,3,0,0,0,0,0,0,0.0,
32,I Danladi (NGA),2019-2019,3,3,0,0,0,0,0,0,0.0,
33,H Davids (SA),2012-2013,9,9,0,0,0,0,0,0,0.0,
34,S Davizi (CZK-R),2019-2019,2,2,0,0,0,0,0,0,0.0,
35,Dawlat Ahmadzai (AFG),2010-2010,2,2,0,0,0,0,0,0,0.0,
36,DC Delany (IRE),2019-2019,8,8,0,0,0,0,0,0,0.0,
37,D de la Puente (Peru),2019-2019,2,2,0,0,0,0,0,0,0.0,
38,PA Desai (CAN),2012-2012,1,1,0,0,0,0,0,0,0.0,
39,ST de Silva (SL),2017-2017,3,3,0,0,0,0,0,0,0.0,
40,BJ Diamanti (NZ),2009-2009,1,1,0,0,0,0,0,0,0.0,
41,V Dikov (),2019-2019,3,3,0,0,0,0,0,0,0.0,
42,LHD Dilhara (SL),2008-2008,2,2,0,0,0,0,0,0,0.0,
43,SDJJ Dima (Moz),2019-2019,4,3,0,0,0,0,0,0,0.0,
44,N Dipakkumar Patel (PNM),2019-2019,3,3,0,0,0,0,0,0,0.0,
45,HH Dippenaar (SA),2006-2006,1,1,0,0,0,0,0,0,0.0,
46,M Dixit (LUX),2019-2019,3,3,0,0,0,0,0,0,0.0,
47,A Djorovic (Serb),2019-2019,2,2,0,0,0,0,0,0,0.0,
48,XJ Doherty (AUS),2012-2013,11,11,0,0,0,0,0,0,0.0,
49,JN Dorji (BHU),2019-2019,1,1,0,0,0,0,0,0,0.0,
0,K Dorji (BHU),2019-2019,2,2,0,0,0,0,0,0,0.0,
1,RM Dorji (BHU),2019-2019,1,1,0,0,0,0,0,0,0.0,
2,U Dorji (BHU),2019-2019,2,2,0,0,0,0,0,0,0.0,
3,TM Dowlin (WI),2009-2010,2,2,0,0,0,0,0,0,0.0,
4,R Dravid (INDIA),2011-2011,1,1,0,0,0,0,0,0,0.0,
5,BM Duckett (ENG),2019-2019,1,1,0,0,0,0,0,0,0.0,
6,B Dugic (Serb),2019-2019,2,2,0,0,0,0,0,0,0.0,
7,J Dunn (VAN),2019-2019,4,4,0,0,0,0,0,0,0.0,
8,PS Eaglestone (IRE),2010-2010,1,1,0,0,0,0,0,0,0.0,
9,KR Ebanks (Caym),2019-2019,5,5,0,0,0,0,0,0,0.0,
10,Ehsan Nawaz (HKG),2014-2017,5,5,0,0,0,0,0,0,0.0,
11,AM Ellis (NZ),2012-2013,5,5,0,0,0,0,0,0,0.0,
12,C Emmott (Chile),2019-2019,2,2,0,0,0,0,0,0,0.0,
13,RR Emrit (WI),2018-2018,4,4,0,0,0,0,0,0,0.0,
14,Faizan Asif (UAE),2014-2015,6,6,0,0,0,0,0,0,0.0,
15,Fakhrul Mohon (PORT),2019-2019,4,4,0,0,0,0,0,0,0.0,
16,Fawad Ahmed (AUS),2013-2013,2,2,0,0,0,0,0,0,0.0,
17,Fazal Niazai (AFG),2019-2019,1,1,0,0,0,0,0,0,0.0,
18,H Fennell (Arg),2019-2019,5,5,0,0,0,0,0,0,0.0,
19,B Fernando (SL),2015-2015,2,2,0,0,0,0,0,0,0.0,
20,BOP Fernando (SL),2019-2019,3,3,0,0,0,0,0,0,0.0,
21,MVT Fernando (SL),2017-2017,1,1,0,0,0,0,0,0,0.0,
22,Fiaz Ahmad (KUW),2019-2019,3,3,0,0,0,0,0,0,0.0,
23,Fida Hussain (ITA),2019-2019,2,2,0,0,0,0,0,0,0.0,
24,R Flannigan (SCOT),2012-2012,4,4,0,0,0,0,0,0,0.0,
25,P Florin (ROM),2019-2019,4,4,0,0,0,0,0,0,0.0,
26,KK Flowers (Blz),2019-2019,3,3,0,0,0,0,0,0,0.0,
27,C Floyd (NL),2019-2019,2,2,0,0,0,0,0,0,0.0,
28,BC Fortuin (SA),2019-2019,2,2,0,0,0,0,0,0,0.0,
29,AR Gandhi (KENYA),2019-2019,3,3,0,0,0,0,0,0,0.0,
30,D Ganga (WI),2006-2006,1,1,0,0,0,0,0,0,0.0,
31,MD Garratt (GIBR),2019-2019,4,4,0,0,0,0,0,0,0.0,
32,Garret Banner (Blz),2019-2019,1,1,0,0,0,0,0,0,0.0,
33,SP Gauchan (NEPAL),2014-2015,9,9,0,0,0,0,0,0,0.0,
34,A Gavde (Caym),2019-2019,1,1,0,0,0,0,0,0,0.0,
35,R Gaznavi (SGP),2019-2019,2,2,0,0,0,0,0,0,0.0,
36,B Geeves (AUS),2009-2009,1,1,0,0,0,0,0,0,0.0,
37,L Gharasim (ROM),2019-2019,2,2,0,0,0,0,0,0,0.0,
38,JN Gillespie (AUS),2005-2005,1,1,0,0,0,0,0,0,0.0,
39,O Goker (TKY),2019-2019,1,1,0,0,0,0,0,0,0.0,
40,GF Gomes (Moz),2019-2019,7,6,0,0,0,0,0,0,0.0,
41,M Goonetilleke (MALTA),2019-2019,1,1,0,0,0,0,0,0,0.0,
42,D Gough (ENG),2005-2006,2,2,0,0,0,0,0,0,0.0,
43,S Goustis (),2019-2019,3,3,0,0,0,0,0,0,0.0,
44,L Gregory (ENG),2019-2019,5,5,0,0,0,0,0,0,0.0,
45,R Gunasekera (CAN),2012-2013,8,8,0,0,0,0,0,0,0.0,
46,HF Gurney (ENG),2014-2014,2,2,0,0,0,0,0,0,0.0,
47,AJ Hall (SA),2006-2006,2,2,0,0,0,0,0,0,0.0,
48,PSP Handscomb (AUS),2019-2019,2,2,0,0,0,0,0,0,0.0,
49,Hardev Singh (Chile),2019-2019,3,3,0,0,0,0,0,0,0.0,
0,Haroon Arshad (HKG),2019-2019,10,10,0,0,0,0,0,0,0.0,
1,Haroon Mughal (MALTA),2019-2019,4,4,0,0,0,0,0,0,0.0,
2,LHB Harrington-Myers (Caym),2019-2019,4,4,0,0,0,0,0,0,0.0,
3,RJ Harris (AUS),2010-2010,3,3,0,0,0,0,0,0,0.0,
4,SM Harwood (AUS),2007-2009,3,3,0,0,0,0,0,0,0.0,
5,Hasheem Shahzad (MALTA),2019-2019,2,2,0,0,0,0,0,0,0.0,
6,Hashmatullah Shahidi (AFG),2013-2013,1,1,0,0,0,0,0,0,0.0,
7,Hassan Rasheed (Mald),2019-2019,8,8,0,0,0,0,0,0,0.0,
8,RJ Hatchman (GIBR),2019-2019,1,1,0,0,0,0,0,0,0.0,
9,Hayatullah Niazi (NOR),2019-2019,4,4,0,0,0,0,0,0,0.0,
10,H Helva (TKY),2019-2019,4,4,0,0,0,0,0,0,0.0,
11,DL Hemp (BMUDA),2008-2008,2,2,0,0,0,0,0,0,0.0,
12,T Henderson (SA),2006-2006,1,1,0,0,0,0,0,0,0.0,
13,PD Hennessy (ESP),2019-2019,8,8,0,0,0,0,0,0,0.0,
14,HMRKB Herath (SL),2011-2016,17,17,0,0,0,0,0,0,0.0,
15,BW Hilfenhaus (AUS),2007-2012,7,7,0,0,0,0,0,0,0.0,
16,J Hill (PHI),2019-2019,4,4,0,0,0,0,0,0,0.0,
17,H Hiri (PNG),2016-2019,5,5,0,0,0,0,0,0,0.0,
18,J Hirschi (MALTA),2019-2019,4,4,0,0,0,0,0,0,0.0,
19,PA Hitchcock (NZ),2008-2008,1,1,0,0,0,0,0,0,0.0,
20,KC Hodsoll (BMUDA),2008-2008,1,1,0,0,0,0,0,0,0.0,
21,S Hongsi (THAI),2019-2019,3,3,0,0,0,0,0,0,0.0,
22,PJ Hughes (AUS),2014-2014,1,1,0,0,0,0,0,0,0.0,
23,EH Hutchinson (USA),2019-2019,2,2,0,0,0,0,0,0,0.0,
24,Ibrahim Khan (Saudi),2019-2019,1,1,0,0,0,0,0,0,0.0,
25,Iftikhar Anjum (PAK),2007-2009,2,2,0,0,0,0,0,0,0.0,
26,Ijaz Hussain (ROM),2019-2019,3,3,0,0,0,0,0,0,0.0,
27,Imam-ul-Haq (PAK),2019-2019,2,2,0,0,0,0,0,0,0.0,
28,Imran Ali Butt (BAH),2019-2019,4,4,0,0,0,0,0,0,0.0,
29,Imran Bulbulia (PNM),2019-2019,3,3,0,0,0,0,0,0,0.0,
30,Imran Khan (PORT),2019-2019,4,4,0,0,0,0,0,0,0.0,
31,RK Inampud (Mex),2019-2019,3,3,0,0,0,0,0,0,0.0,
32,Inzamam-ul-Haq (PAK),2006-2006,1,1,0,0,0,0,0,0,0.0,
33,AJ Ireland (ZIM),2006-2006,1,1,0,0,0,0,0,0,0.0,
34,Irfan Bhima (MWI),2019-2019,4,4,0,0,0,0,0,0,0.0,
35,Irfan Mir (Chile),2019-2019,4,4,0,0,0,0,0,0,0.0,
36,E Isaneez (UGA),2019-2019,3,3,0,0,0,0,0,0,0.0,
37,B Ivanov (),2019-2019,3,3,0,0,0,0,0,0,0.0,
38,D Jakiel (ZIM),2019-2019,2,2,0,0,0,0,0,0,0.0,
39,NA Janes (THAI),2019-2019,2,2,0,0,0,0,0,0,0.0,
40,T Jamtsho (BHU),2019-2019,2,2,0,0,0,0,0,0,0.0,
41,Javed Ahmadi (AFG),2012-2017,3,3,0,0,0,0,0,0,0.0,
42,Javed Maroofkhail (NOR),2019-2019,2,2,0,0,0,0,0,0,0.0,
43,CU Jayasinghe (SL),2009-2010,5,5,0,0,0,0,0,0,0.0,
44,P Jayeshbhai Patel (PNM),2019-2019,2,2,0,0,0,0,0,0,0.0,
45,Jay Odedra (OMAN),2019-2019,3,3,0,0,0,0,0,0,0.0,
46,JS Jesani (KENYA),2007-2007,1,1,0,0,0,0,0,0,0.0,
47,HJ Jordaan (THAI),2019-2019,4,4,0,0,0,0,0,0,0.0,
48,GJ Joseph (Blz),2019-2019,1,1,0,0,0,0,0,0,0.0,
49,K Joshi (Aut),2019-2019,4,4,0,0,0,0,0,0,0.0,
0,Jubair Hossain (BDESH),2015-2015,1,1,0,0,0,0,0,0,0.0,
1,Junaid Khan (PAK),2011-2014,9,9,0,0,0,0,0,0,0.0,
2,S Jyoti (CAN),2008-2008,2,2,0,0,0,0,0,0,0.0,
3,Kaleemullah (OMAN),2017-2019,6,6,0,0,0,0,0,0,0.0,
4,G Kaltongga (VAN),2019-2019,3,3,0,0,0,0,0,0,0.0,
5,S Randiv (SL),2010-2011,7,7,0,0,0,0,0,0,0.0,
6,TP Kamungozi (ZIM),2014-2014,1,1,0,0,0,0,0,0,0.0,
7,S Kansoy (TKY),2019-2019,4,4,0,0,0,0,0,0,0.0,
8,A Karn (NEPAL),2015-2015,2,2,0,0,0,0,0,0,0.0,
9,M Kartik (INDIA),2007-2007,1,1,0,0,0,0,0,0,0.0,
10,E Katchay (CAN),2008-2008,4,4,0,0,0,0,0,0,0.0,
11,S Kaul (INDIA),2018-2019,3,3,0,0,0,0,0,0,0.0,
12,HB Kayondo (UGA),2019-2019,3,3,0,0,0,0,0,0,0.0,
13,D Kegasitswe (Botsw),2019-2019,4,4,0,0,0,0,0,0,0.0,
14,SKW Kelly (BMUDA),2008-2008,3,3,0,0,0,0,0,0,0.0,
15,P Kerai (KENYA),2019-2019,6,6,0,0,0,0,0,0,0.0,
16,A Khan (ENG),2009-2009,1,1,0,0,0,0,0,0,0.0,
17,B Khumalo (Botsw),2019-2019,3,3,0,0,0,0,0,0,0.0,
18,Khurram Manzoor (PAK),2016-2016,3,3,0,0,0,0,0,0,0.0,
19,Khushdil Shah (PAK),2019-2019,1,1,0,0,0,0,0,0,0.0,
20,JH Kiani (PHI),2019-2019,4,4,0,0,0,0,0,0,0.0,
21,GE Kidd (IRE),2010-2010,1,1,0,0,0,0,0,0,0.0,
22,VJ Kingma (NL),2016-2019,4,4,0,0,0,0,0,0,0.0,
23,RJ Kirtley (ENG),2007-2007,1,1,0,0,0,0,0,0,0.0,
24,S Kizilkaya (TKY),2019-2019,4,4,0,0,0,0,0,0,0.0,
25,MF Koc (TKY),2019-2019,2,2,0,0,0,0,0,0,0.0,
26,AC Kose (TKY),2019-2019,4,4,0,0,0,0,0,0,0.0,
27,A Krishna (SGP),2019-2019,4,4,0,0,0,0,0,0,0.0,
28,GJP Kruger (SA),2006-2006,1,1,0,0,0,0,0,0,0.0,
29,DS Kulkarni (INDIA),2016-2016,2,2,0,0,0,0,0,0,0.0,
30,CBRLS Kumara (SL),2019-2019,3,3,0,0,0,0,0,0,0.0,
31,Kushal Malla (NEPAL),2019-2019,3,3,0,0,0,0,0,0,0.0,
32,GA Lamb (ZIM),2010-2010,5,5,0,0,0,0,0,0,0.0,
33,T Langa (VAN),2019-2019,1,1,0,0,0,0,0,0,0.0,
34,E Leie (SA),2015-2015,2,2,0,0,0,0,0,0,0.0,
35,RDM Leverock (BMUDA),2008-2008,2,2,0,0,0,0,0,0,0.0,
36,I Lisboa (Chile),2019-2019,1,1,0,0,0,0,0,0,0.0,
37,LS Livingstone (ENG),2017-2017,2,2,0,0,0,0,0,0,0.0,
38,CA Liyanage (Mald),2019-2019,2,2,0,0,0,0,0,0,0.0,
39,K Loday (BHU),2019-2019,1,1,0,0,0,0,0,0,0.0,
40,J Louw (SA),2008-2009,2,2,0,0,0,0,0,0,0.0,
41,L Louwrens (NAM),2019-2019,1,1,0,0,0,0,0,0,0.0,
42,Lucky Ali (DEN),2019-2019,2,2,0,0,0,0,0,0,0.0,
43,NM Lyon (AUS),2016-2018,2,2,0,0,0,0,0,0,0.0,
44,RT Lyons (SCOT),2010-2010,2,2,0,0,0,0,0,0,0.0,
45,AM McCarthy (WI),2018-2018,1,1,0,0,0,0,0,0,0.0,
46,NFI McCallum (SCOT),2007-2010,11,10,0,0,0,0,0,0,0.0,
47,OC McCoy (WI),2019-2019,2,2,0,0,0,0,0,0,0.0,
48,AJ McKay (NZ),2010-2010,2,2,0,0,0,0,0,0,0.0,
49,CJ McKay (AUS),2010-2013,6,6,0,0,0,0,0,0,0.0,
0,ND McKenzie (SA),2006-2009,2,2,0,0,0,0,0,0,0.0,
1,DSK Madushanka (SL),2018-2018,2,2,0,0,0,0,0,0,0.0,
2,LD Madushanka (SL),2019-2019,2,2,0,0,0,0,0,0,0.0,
3,RP Magar (NEPAL),2014-2015,6,6,0,0,0,0,0,0,0.0,
4,R Mahajan (PHI),2019-2019,3,3,0,0,0,0,0,0,0.0,
5,C Mahoney (Peru),2019-2019,3,3,0,0,0,0,0,0,0.0,
6,Mamoon Latif (Belg),2019-2019,3,3,0,0,0,0,0,0,0.0,
7,G Manan (ROM),2019-2019,3,3,0,0,0,0,0,0,0.0,
8,D Manani (ROM),2019-2019,2,2,0,0,0,0,0,0,0.0,
9,M Markande (INDIA),2019-2019,1,1,0,0,0,0,0,0,0.0,
10,D Marks (MALTA),2019-2019,2,2,0,0,0,0,0,0,0.0,
11,JAH Marshall (NZ),2005-2008,3,3,0,0,0,0,0,0,0.0,
12,JL Martel (GUE),2019-2019,3,3,0,0,0,0,0,0,0.0,
13,B Masaba (UGA),2019-2019,1,1,0,0,0,0,0,0,0.0,
14,MJ Mason (NZ),2006-2008,3,3,0,0,0,0,0,0,0.0,
15,N Master (Botsw),2019-2019,2,2,0,0,0,0,0,0,0.0,
16,ZE Matsinhe (Moz),2019-2019,7,6,0,0,0,0,0,0,0.0,
17,V Mbazo (Botsw),2019-2019,4,4,0,0,0,0,0,0,0.0,
18,GJ McCarter (IRE),2015-2015,3,2,0,0,0,0,0,0,0.0,
19,BJ McCarthy (IRE),2017-2018,6,6,0,0,0,0,0,0,0.0,
20,Z McLaughlin (Caym),2019-2019,3,3,0,0,0,0,0,0,0.0,
21,A Mehmood (HKG),2016-2016,2,2,0,0,0,0,0,0,0.0,
22,Mehrab Hossain jnr (BDESH),2008-2009,2,2,0,0,0,0,0,0,0.0,
23,D Mejia (CRC),2019-2019,3,3,0,0,0,0,0,0,0.0,
24,K Mendon (CZK-R),2019-2019,6,6,0,0,0,0,0,0,0.0,
25,JH Mensah (Ghana),2019-2019,2,2,0,0,0,0,0,0,0.0,
26,DP Michael (Samoa),2019-2019,4,4,0,0,0,0,0,0,0.0,
27,Michael Nazir (MALTA),2019-2019,1,1,0,0,0,0,0,0,0.0,
28,Mihusan Hamid (Mald),2019-2019,1,1,0,0,0,0,0,0,0.0,
29,Mirza Ahsan (Aut),2019-2019,5,5,0,0,0,0,0,0,0.0,
30,Mohamed Arief (MAL),2019-2019,5,5,0,0,0,0,0,0,0.0,
31,Mohameed Taiwo (NGA),2019-2019,2,2,0,0,0,0,0,0,0.0,
32,Mohammad Adnan (Saudi),2019-2019,5,5,0,0,0,0,0,0,0.0,
33,Mohammad Ahsan (KUW),2019-2019,6,6,0,0,0,0,0,0,0.0,
34,Mohammad Amin (KUW),2019-2019,4,4,0,0,0,0,0,0,0.0,
35,Mohammad Hasnain (PAK),2019-2019,4,4,0,0,0,0,0,0,0.0,
36,Mohammad Iqbal (CAN),2008-2008,3,3,0,0,0,0,0,0,0.0,
37,Mohamed Mahfooz (Mald),2019-2019,11,11,0,0,0,0,0,0,0.0,
38,Mohammad Qazi (CAN),2008-2008,1,1,0,0,0,0,0,0,0.0,
39,Mohammad Rafique (BDESH),2006-2006,1,1,0,0,0,0,0,0,0.0,
40,Mohammad Shahid (BDESH),2016-2016,1,1,0,0,0,0,0,0,0.0,
41,Mohammed Shami (INDIA),2014-2019,8,8,0,0,0,0,0,0,0.0,
42,MR Montfort (CAN),2019-2019,1,1,0,0,0,0,0,0,0.0,
43,VV Morea (PNG),2015-2017,5,5,0,0,0,0,0,0,0.0,
44,A Morris (Caym),2019-2019,6,6,0,0,0,0,0,0,0.0,
45,JWN Moses (Botsw),2019-2019,3,3,0,0,0,0,0,0,0.0,
46,Mohsin Hub (Peru),2019-2019,4,4,0,0,0,0,0,0,0.0,
47,Muaviath Ganee (Mald),2019-2019,5,5,0,0,0,0,0,0,0.0,
48,Muhammad Hamayun (Saudi),2019-2019,4,4,0,0,0,0,0,0,0.0,
49,Muhammad Musa (PAK),2019-2019,1,1,0,0,0,0,0,0,0.0,
0,Muhammad Rafique (BAH),2019-2019,2,2,0,0,0,0,0,0,0.0,
1,Muhammed Shanil (UAE),2016-2016,1,1,0,0,0,0,0,0,0.0,
2,Muhammad Wafiq (MAL),2019-2019,4,4,0,0,0,0,0,0,0.0,
3,D Muhumuza (UGA),2019-2019,4,4,0,0,0,0,0,0,0.0,
4,Mukhtiar Singh (ESP),2019-2019,2,2,0,0,0,0,0,0,0.0,
5,Muktar Ali (BDESH),2016-2016,1,1,0,0,0,0,0,0,0.0,
6,FF Mulivai (Samoa),2019-2019,4,4,0,0,0,0,0,0,0.0,
7,T Mupariwa (ZIM),2007-2008,4,4,0,0,0,0,0,0,0.0,
8,S Murari (CRC),2019-2019,3,3,0,0,0,0,0,0,0.0,
9,Musa Shaheen (DEN),2019-2019,1,1,0,0,0,0,0,0,0.0,
10,P Mustard (ENG),2008-2008,2,2,0,0,0,0,0,0,0.0,
11,F Mutizwa (ZIM),2011-2012,3,3,0,0,0,0,0,0,0.0,
12,Nadif Chowdhury (BDESH),2006-2007,3,3,0,0,0,0,0,0,0.0,
13,S Nadigotla (ROM),2019-2019,2,2,0,0,0,0,0,0,0.0,
14,Najeeb Amar (HKG),2014-2014,1,1,0,0,0,0,0,0,0.0,
15,A Nanda (LUX),2019-2019,3,3,0,0,0,0,0,0,0.0,
16,M Nandela (Mex),2019-2019,2,2,0,0,0,0,0,0,0.0,
17,A Nao (PNG),2017-2017,2,2,0,0,0,0,0,0,0.0,
18,Nasir Aziz (UAE),2015-2015,1,1,0,0,0,0,0,0,0.0,
19,Nasrulla Rana (HKG),2019-2019,8,8,0,0,0,0,0,0,0.0,
20,Nauman Anwar (PAK),2015-2015,1,1,0,0,0,0,0,0,0.0,
21,NH Naureen (ESP),2019-2019,1,1,0,0,0,0,0,0,0.0,
22,Naveen-ul-Haq (AFG),2019-2019,4,4,0,0,0,0,0,0,0.0,
23,Nawaf Ahmed (KUW),2019-2019,1,1,0,0,0,0,0,0,0.0,
24,Nazimuddin (BDESH),2007-2008,7,7,0,0,0,0,0,0,0.0,
25,Nazmul Hossain (BDESH),2009-2012,4,4,0,0,0,0,0,0,0.0,
26,Nazmus Sadat (BDESH),2006-2006,1,1,0,0,0,0,0,0,0.0,
27,R Neale (LUX),2019-2019,3,3,0,0,0,0,0,0,0.0,
28,S Nerandzic (Serb),2019-2019,2,2,0,0,0,0,0,0,0.0,
29,R Ngarava (ZIM),2019-2019,1,1,0,0,0,0,0,0,0.0,
30,JO Ngoche (KENYA),2012-2013,7,7,0,0,0,0,0,0,0.0,
31,HM Nicholls (NZ),2016-2019,5,5,0,0,0,0,0,0,0.0,
32,D Nikolov (),2019-2019,3,3,0,0,0,0,0,0,0.0,
33,K Nima (BHU),2019-2019,1,1,0,0,0,0,0,0,0.0,
34,ML Nkala (ZIM),2006-2006,1,1,0,0,0,0,0,0,0.0,
35,F Nkhoma (MWI),2019-2019,4,4,0,0,0,0,0,0,0.0,
36,AA Noffke (AUS),2007-2008,2,2,0,0,0,0,0,0,0.0,
37,Noman Kamawi (Belg),2019-2019,1,1,0,0,0,0,0,0,0.0,
38,MJ North (AUS),2009-2009,1,1,0,0,0,0,0,0,0.0,
39,A Nortje (SA),2019-2019,1,1,0,0,0,0,0,0,0.0,
40,L Nou (PNG),2015-2015,3,3,0,0,0,0,0,0,0.0,
41,GM Ntambalika (MWI),2019-2019,3,3,0,0,0,0,0,0,0.0,
42,J Nyumbu (ZIM),2018-2018,2,2,0,0,0,0,0,0,0.0,
43,IE O'Brien (NZ),2009-2009,4,4,0,0,0,0,0,0,0.0,
44,NV Ojha (INDIA),2010-2010,2,2,0,0,0,0,0,0,0.0,
45,PJ Ongondo (KENYA),2007-2008,8,8,0,0,0,0,0,0,0.0,
46,LN Onyango (KENYA),2007-2010,5,5,0,0,0,0,0,0,0.0,
47,A Orfila (GIBR),2019-2019,1,1,0,0,0,0,0,0,0.0,
48,Ovais Yousof (NGA),2019-2019,3,3,0,0,0,0,0,0,0.0,
49,VS Padhaal (Fin),2019-2019,5,5,0,0,0,0,0,0,0.0,
0,BA Pai (GIBR),2019-2019,4,4,0,0,0,0,0,0,0.0,
1,RJG Palmer (JER),2019-2019,2,2,0,0,0,0,0,0,0.0,
2,MS Panesar (ENG),2007-2007,1,1,0,0,0,0,0,0,0.0,
3,BA Parchment (WI),2007-2007,1,1,0,0,0,0,0,0,0.0,
4,MA Parker (SCOT),2012-2012,2,2,0,0,0,0,0,0,0.0,
5,MW Parkinson (ENG),2019-2019,2,2,0,0,0,0,0,0,0.0,
6,Parvez Rasool (INDIA),2017-2017,1,1,0,0,0,0,0,0,0.0,
7,A Patel (MWI),2019-2019,2,2,0,0,0,0,0,0,0.0,
8,AY Patel (NZ),2018-2018,2,2,0,0,0,0,0,0,0.0,
9,M Patel (PNM),2019-2019,2,2,0,0,0,0,0,0,0.0,
10,M Patel (Chile),2019-2019,3,3,0,0,0,0,0,0,0.0,
11,MIA Patel (MWI),2019-2019,3,3,0,0,0,0,0,0,0.0,
12,MM Patel (INDIA),2011-2011,3,3,0,0,0,0,0,0,0.0,
13,TK Patel (USA),2019-2019,7,7,0,0,0,0,0,0,0.0,
14,N Pathan (THAI),2019-2019,4,4,0,0,0,0,0,0,0.0,
15,SS Pathirana (SL),2016-2017,5,5,0,0,0,0,0,0,0.0,
16,WA Peatfield (GUE),2019-2019,8,8,0,0,0,0,0,0,0.0,
17,MDK Perera (SL),2011-2011,3,3,0,0,0,0,0,0,0.0,
18,PDRL Perera (SL),2006-2006,2,2,0,0,0,0,0,0,0.0,
19,S Periyalwar (ROM),2019-2019,4,4,0,0,0,0,0,0,0.0,
20,V Permaul (WI),2018-2018,1,1,0,0,0,0,0,0,0.0,
21,AM Phangiso (SA),2012-2018,16,16,0,0,0,0,0,0,0.0,
22,T Phaswana (Botsw),2019-2019,1,1,0,0,0,0,0,0,0.0,
23,S Pillai (CRC),2019-2019,3,3,0,0,0,0,0,0,0.0,
24,LA Pomersbach (AUS),2007-2007,1,1,0,0,0,0,0,0,0.0,
25,VRCF Poubel (),2019-2019,3,3,0,0,0,0,0,0,0.0,
26,H Pragji (Botsw),2019-2019,4,4,0,0,0,0,0,0,0.0,
27,C Prasad (CRC),2019-2019,3,3,0,0,0,0,0,0,0.0,
28,KTGD Prasad (SL),2011-2011,1,1,0,0,0,0,0,0,0.0,
29,D Pretorius (SA),2017-2019,6,6,0,0,0,0,0,0,0.0,
30,AG Prince (SA),2005-2005,1,1,0,0,0,0,0,0,0.0,
31,SMA Priyanjan (SL),2017-2017,3,3,0,0,0,0,0,0,0.0,
32,Qalandar Khan (QAT),2019-2019,4,4,0,0,0,0,0,0,0.0,
33,Qasim Zia (BAH),2019-2019,3,3,0,0,0,0,0,0,0.0,
34,Rafatullah Mohmand (PAK),2015-2015,3,3,0,0,0,0,0,0,0.0,
35,Rahman Ademi (Serb),2019-2019,2,2,0,0,0,0,0,0,0.0,
36,P Raho (PNG),2016-2016,2,2,0,0,0,0,0,0,0.0,
37,EC Rainsford (ZIM),2010-2010,2,2,0,0,0,0,0,0,0.0,
38,PBB Rajapaksa (SL),2019-2019,5,5,0,0,0,0,0,0,0.0,
39,Raja Adeel (ESP),2019-2019,3,3,0,0,0,0,0,0,0.0,
40,CAK Rajitha (SL),2016-2019,10,10,0,0,0,0,0,0,0.0,
41,Rakibul Hasan (ITA),2019-2019,8,7,0,0,0,0,0,0,0.0,
42,RLB Rambukwella (SL),2013-2016,2,2,0,0,0,0,0,0,0.0,
43,Rameez Raja (2) (PAK),2011-2011,2,2,0,0,0,0,0,0,0.0,
44,SHA Rance (NZ),2017-2019,8,7,0,0,0,0,0,0,0.0,
45,DA Rankin (IRE),2015-2016,2,2,0,0,0,0,0,0,0.0,
46,RJ Ranpura (OMAN),2015-2016,3,2,0,0,0,0,0,0,0.0,
47,Rashid Khan (NEPAL),2019-2019,1,1,0,0,0,0,0,0,0.0,
48,KB Ratilal (PNM),2019-2019,3,3,0,0,0,0,0,0,0.0,
49,Ravinder Singh (MALTA),2019-2019,2,2,0,0,0,0,0,0,0.0,
0,Razmal Shigiwal (Aut),2019-2019,4,4,0,0,0,0,0,0,0.0,
1,NJ Reardon (AUS),2014-2014,2,2,0,0,0,0,0,0,0.0,
2,J Reb (Serb),2019-2019,2,2,0,0,0,0,0,0,0.0,
3,Riazat Ali Shah (UGA),2019-2019,4,4,0,0,0,0,0,0,0.0,
4,ACL Richards (WI),2007-2007,1,1,0,0,0,0,0,0,0.0,
5,DM Richards (WI),2009-2009,1,1,0,0,0,0,0,0,0.0,
6,EB Ringera (KENYA),2019-2019,1,1,0,0,0,0,0,0,0.0,
7,R Rivas (Chile),2019-2019,3,3,0,0,0,0,0,0,0.0,
8,CP Rizwan (UAE),2019-2019,5,5,0,0,0,0,0,0,0.0,
9,Rizwan Mahmood (DEN),2019-2019,5,3,0,0,0,0,0,0,0.0,
10,WJR Robertson (JER),2019-2019,6,6,0,0,0,0,0,0,0.0,
11,Robiul Islam (BDESH),2013-2013,1,1,0,0,0,0,0,0,0.0,
12,GA Rogers (SCOT),2008-2009,2,2,0,0,0,0,0,0,0.0,
13,BJ Rohrer (AUS),2013-2013,1,1,0,0,0,0,0,0,0.0,
14,Rokhan Barakzai (AFG),2015-2015,3,3,0,0,0,0,0,0,0.0,
15,Rony Talukdar (BDESH),2015-2015,1,1,0,0,0,0,0,0,0.0,
16,JA Rudolph (SA),2006-2006,1,1,0,0,0,0,0,0,0.0,
17,SI Runsewe (NGA),2019-2019,6,6,0,0,0,0,0,0,0.0,
18,AK Sah (NEPAL),2018-2018,1,1,0,0,0,0,0,0,0.0,
19,TK Saha (Fin),2019-2019,4,4,0,0,0,0,0,0,0.0,
20,Sajid Liaqat (GER),2019-2019,2,2,0,0,0,0,0,0,0.0,
21,Sakib Hasan (Serb),2019-2019,2,2,0,0,0,0,0,0,0.0,
22,BA Sambo (Moz),2019-2019,2,2,0,0,0,0,0,0,0.0,
23,O Sam Arthur (CRC),2019-2019,3,3,0,0,0,0,0,0,0.0,
24,Sandeep Sharma (INDIA),2015-2015,2,2,0,0,0,0,0,0,0.0,
25,Saqlain Ali (Belg),2019-2019,2,2,0,0,0,0,0,0,0.0,
26,Saqlain Sajib (BDESH),2016-2016,1,1,0,0,0,0,0,0,0.0,
27,Sarfaraz Ali (BAH),2019-2019,4,4,0,0,0,0,0,0,0.0,
28,R Satheesan (ROM),2019-2019,4,4,0,0,0,0,0,0,0.0,
29,JOP Scamans (Fin),2019-2019,2,2,0,0,0,0,0,0,0.0,
30,K Senamontree (THAI),2019-2019,2,2,0,0,0,0,0,0,0.0,
31,YSD Seneveratne (Caym),2019-2019,6,6,0,0,0,0,0,0,0.0,
32,M Sert (TKY),2019-2019,4,4,0,0,0,0,0,0,0.0,
33,Shabbir Ahmed (PAK),2007-2007,1,1,0,0,0,0,0,0,0.0,
34,Shabir Noori (AFG),2012-2012,1,1,0,0,0,0,0,0,0.0,
35,L Shafeeg (Mald),2019-2019,3,3,0,0,0,0,0,0,0.0,
36,Shahadat Hossain (BDESH),2006-2013,6,6,0,0,0,0,0,0,0.0,
37,Shahbaz Badar (BAH),2019-2019,3,3,0,0,0,0,0,0,0.0,
38,Shahzad Muhammad (Mex),2019-2019,2,2,0,0,0,0,0,0,0.0,
39,Sharif Asadullah (UAE),2014-2014,1,1,0,0,0,0,0,0,0.0,
40,KV Sharma (INDIA),2014-2014,1,1,0,0,0,0,0,0,0.0,
41,R Sharma (INDIA),2012-2012,2,2,0,0,0,0,0,0,0.0,
42,ZK Shem (VAN),2019-2019,5,5,0,0,0,0,0,0,0.0,
43,Shoaib Gazi Hossain (Chile),2019-2019,4,4,0,0,0,0,0,0,0.0,
44,PM Siddle (AUS),2009-2010,2,2,0,0,0,0,0,0,0.0,
45,KM Silva (),2019-2019,3,3,0,0,0,0,0,0,0.0,
46,BA Simango (Moz),2019-2019,2,2,0,0,0,0,0,0,0.0,
47,LA Simango (Moz),2019-2019,3,3,0,0,0,0,0,0,0.0,
48,M Simmons (BMUDA),2019-2019,2,2,0,0,0,0,0,0,0.0,
49,Simranjit Singh (ITA),2019-2019,1,1,0,0,0,0,0,0,0.0,
0,MS Sinclair (NZ),2005-2007,2,2,0,0,0,0,0,0,0.0,
1,H Singh (GER),2019-2019,7,7,0,0,0,0,0,0,0.0,
2,S Singh (PHI),2019-2019,4,4,0,0,0,0,0,0,0.0,
3,S Singh (PORT),2019-2019,1,1,0,0,0,0,0,0,0.0,
4,JR Singleton (),2019-2019,3,3,0,0,0,0,0,0,0.0,
5,T Singye (BHU),2019-2019,2,2,0,0,0,0,0,0,0.0,
6,RM Siri (Arg),2019-2019,4,4,0,0,0,0,0,0,0.0,
7,DC Smith (PHI),2019-2019,4,4,0,0,0,0,0,0,0.0,
8,OF Smith (WI),2018-2018,2,2,0,0,0,0,0,0,0.0,
9,RAJ Smith (SCOT),2019-2019,2,2,0,0,0,0,0,0,0.0,
10,Sohail Khan (PAK),2008-2017,5,5,0,0,0,0,0,0,0.0,
11,S Sohal (USA),2019-2019,3,3,0,0,0,0,0,0,0.0,
12,Soheel Hussain (Belg),2019-2019,1,1,0,0,0,0,0,0,0.0,
13,M Sohel Patel (PNM),2019-2019,2,2,0,0,0,0,0,0,0.0,
14,Sohrawordi Shuvo (BDESH),2010-2010,1,1,0,0,0,0,0,0,0.0,
15,S Sola (Samoa),2019-2019,4,4,0,0,0,0,0,0,0.0,
16,S Soosiyakumar (),2019-2019,1,1,0,0,0,0,0,0,0.0,
17,ES Soto (CRC),2019-2019,1,1,0,0,0,0,0,0,0.0,
18,M Spry (Peru),2019-2019,4,4,0,0,0,0,0,0,0.0,
19,BB Sran (INDIA),2016-2016,2,2,0,0,0,0,0,0,0.0,
20,L Sreekumar (UAE),2017-2017,1,1,0,0,0,0,0,0,0.0,
21,H Ssenyondo (UGA),2019-2019,4,4,0,0,0,0,0,0,0.0,
22,AJ Staal (NL),2019-2019,9,9,0,0,0,0,0,0,0.0,
23,B Stanlake (AUS),2017-2019,19,19,0,0,0,0,0,0,0.0,
24,AL Stephen (VAN),2019-2019,2,2,0,0,0,0,0,0,0.0,
25,BS Stephenson (Blz),2019-2019,3,3,0,0,0,0,0,0,0.0,
26,TJ Stephenson (Blz),2019-2019,1,1,0,0,0,0,0,0,0.0,
27,Suhail Sadiq (LUX),2019-2019,2,2,0,0,0,0,0,0,0.0,
28,Suhrid Roy (MALTA),2019-2019,1,1,0,0,0,0,0,0,0.0,
29,Sumair Khan (MALTA),2019-2019,1,1,0,0,0,0,0,0,0.0,
30,Suresh Kumar (Peru),2019-2019,2,2,0,0,0,0,0,0,0.0,
31,ZE Surkari (CAN),2008-2008,4,4,0,0,0,0,0,0,0.0,
32,MJ Swepson (AUS),2018-2018,1,1,0,0,0,0,0,0,0.0,
33,Syazrul Idrus (MAL),2019-2019,2,2,0,0,0,0,0,0,0.0,
34,Tafseer Ali (NOR),2019-2019,5,5,0,0,0,0,0,0,0.0,
35,Taijul Islam (BDESH),2019-2019,2,2,0,0,0,0,0,0,0.0,
36,Talha Khan (GER),2019-2019,1,1,0,0,0,0,0,0,0.0,
37,Tanvir Ahmed (PAK),2010-2010,1,1,0,0,0,0,0,0,0.0,
38,Tariq Aziz (PORT),2019-2019,4,4,0,0,0,0,0,0,0.0,
39,Tarun Sharma (Mex),2019-2019,8,8,0,0,0,0,0,0,0.0,
40,R Telemachus (SA),2006-2007,3,3,0,0,0,0,0,0,0.0,
41,VE Tembo (Moz),2019-2019,6,5,0,0,0,0,0,0,0.0,
42,H Thaker (CAN),2019-2019,1,1,0,0,0,0,0,0,0.0,
43,J Thinley (BHU),2019-2019,2,2,0,0,0,0,0,0,0.0,
44,AC Thomas (SA),2007-2007,1,1,0,0,0,0,0,0,0.0,
45,O Thomas (WI),2018-2019,10,10,0,0,0,0,0,0,0.0,
46,EP Thompson (NZ),2008-2008,1,1,0,0,0,0,0,0,0.0,
47,S Thuraisingam (CAN),2008-2008,3,3,0,0,0,0,0,0,0.0,
48,SF Tiai (Samoa),2019-2019,4,4,0,0,0,0,0,0,0.0,
49,BM Tickner (NZ),2019-2019,3,3,0,0,0,0,0,0,0.0,
0,CT Tremlett (ENG),2007-2007,1,1,0,0,0,0,0,0,0.0,
1,IJL Trott (ENG),2007-2010,7,7,0,0,0,0,0,0,0.0,
2,RJ Trott (BMUDA),2008-2019,15,15,0,0,0,0,0,0,0.0,
3,TE Tucker (BMUDA),2008-2008,1,1,0,0,0,0,0,0,0.0,
4,DR Tuffey (NZ),2005-2010,3,3,0,0,0,0,0,0,0.0,
5,T Turan (TKY),2019-2019,4,4,0,0,0,0,0,0,0.0,
6,HER Tyler (PHI),2019-2019,2,2,0,0,0,0,0,0,0.0,
7,ML Udawatte (SL),2008-2017,8,8,0,0,0,0,0,0,0.0,
8,T Ulutuna (TKY),2019-2019,3,3,0,0,0,0,0,0,0.0,
9,R Ulutuna (TKY),2019-2019,4,4,0,0,0,0,0,0,0.0,
10,Umair Ali (UAE),2015-2015,3,3,0,0,0,0,0,0,0.0,
11,J Umanath (Mex),2019-2019,7,7,0,0,0,0,0,0,0.0,
12,Usman Mushtaq (UAE),2016-2016,3,3,0,0,0,0,0,0,0.0,
13,WPUJC Vaas (SL),2006-2007,6,6,0,0,0,0,0,0,0.0,
14,JJ van der Wath (SA),2006-2007,8,8,0,0,0,0,0,0,0.0,
15,VB van Jaarsveld (SA),2009-2009,3,3,0,0,0,0,0,0,0.0,
16,S Varathappan (KUW),2019-2019,3,3,0,0,0,0,0,0,0.0,
17,MP Vaughan (ENG),2005-2007,2,2,0,0,0,0,0,0,0.0,
18,G Venkateswaran (LUX),2019-2019,3,3,0,0,0,0,0,0,0.0,
19,JK Vifah (Ghana),2019-2019,3,3,0,0,0,0,0,0,0.0,
20,V Vijh (LUX),2019-2019,4,4,0,0,0,0,0,0,0.0,
21,Vikramjit Singh (NL),2019-2019,1,1,0,0,0,0,0,0,0.0,
22,DJ Vilas (SA),2012-2012,1,1,0,0,0,0,0,0,0.0,
23,TC Vine (ESP),2019-2019,6,6,0,0,0,0,0,0,0.0,
24,R Vishwanath (LUX),2019-2019,2,2,0,0,0,0,0,0,0.0,
25,C Vorster (GUE),2019-2019,1,1,0,0,0,0,0,0,0.0,
26,Walid Ghauri (NOR),2019-2019,4,4,0,0,0,0,0,0,0.0,
27,T Wangchuk jnr (BHU),2019-2019,2,2,0,0,0,0,0,0,0.0,
28,S Waqas Ahmed (NOR),2019-2019,5,5,0,0,0,0,0,0,0.0,
29,Waqas Khan (HKG),2014-2017,8,8,0,0,0,0,0,0,0.0,
30,Waqas Maqsood (PAK),2018-2018,1,1,0,0,0,0,0,0,0.0,
31,Waqas Raja (Fin),2019-2019,1,1,0,0,0,0,0,0,0.0,
32,I Wardlaw (SCOT),2013-2013,4,4,0,0,0,0,0,0,0.0,
33,Wasim Ali (OMAN),2019-2019,1,1,0,0,0,0,0,0,0.0,
34,SMK Waththage (CZK-R),2019-2019,5,5,0,0,0,0,0,0,0.0,
35,UWMBCA Welegedara (SL),2010-2010,2,2,0,0,0,0,0,0,0.0,
36,T Whiteman (LUX),2019-2019,4,4,0,0,0,0,0,0,0.0,
37,SG Whittingham (SCOT),2018-2018,3,3,0,0,0,0,0,0,0.0,
38,G Wijekoon (SL),2007-2007,3,3,0,0,0,0,0,0,0.0,
39,JW Wilson (NZ),2005-2005,1,1,0,0,0,0,0,0,0.0,
40,MA Wood (ENG),2015-2019,5,5,0,0,0,0,0,0,0.0,
41,Yamin Ahmadzai (AFG),2015-2015,2,2,0,0,0,0,0,0,0.0,
42,N Yordanov (),2019-2019,2,2,0,0,0,0,0,0,0.0,
43,Zain ul Tashnam (CRC),2019-2019,3,3,0,0,0,0,0,0,0.0,
44,Zakir Hasan (BDESH),2018-2018,1,1,0,0,0,0,0,0,0.0,
45,Zaki Ul Hassan (Belg),2019-2019,3,3,0,0,0,0,0,0,0.0,
46,Zamir Khan (AFG),2012-2012,1,1,0,0,0,0,0,0,0.0,
47,S Zargar (Mex),2019-2019,1,1,0,0,0,0,0,0,0.0,
48,Zeeshan Siddiqui (OMAN),2015-2015,5,5,0,0,0,0,0,0,0.0,
49,Zeshan Arif (Aut),2019-2019,4,4,0,0,0,0,0,0,0.0,
0,Ziaur Rahman (AFG),2019-2019,1,1,0,0,0,0,0,0,0.000,
1,Ziaur Rehman (Fin),2019-2019,1,1,0,0,0,0,0,0,0.000,
2,Zohaib Sarwar (PORT),2019-2019,4,4,0,0,0,0,0,0,0.000,
3,M Zondeki (SA),2006-2006,1,1,0,0,0,0,0,0,0.000,
4,GMC Mol (NL),2008-2008,1,-,-,-,-,-,-,-,-,
5,JD Schoonheim (NL),2008-2008,1,-,-,-,-,-,-,-,-,
